Region;Prøvetagningsdato;Køn;Bekræftede tilfælde;Døde;Indlæggelser;Kummuleret antal døde;Kummuleret antal bekræftede tilfælde;Kummuleret antal indlæggelser
Sjælland;26-2-2020;M;1;0;0;0;1;0
Hovedstaden;27-2-2020;M;1;0;0;0;2;0
Midtjylland;28-2-2020;M;1;0;0;0;3;0
Hovedstaden;1-3-2020;M;1;0;1;0;4;1
Hovedstaden;2-3-2020;M;2;0;1;0;6;2
Sjælland;2-3-2020;M;1;0;0;0;7;2
Syddanmark;2-3-2020;M;1;0;0;0;8;2
Hovedstaden;3-3-2020;F;1;0;0;0;9;2
Hovedstaden;3-3-2020;M;3;0;1;0;12;3
Hovedstaden;4-3-2020;M;2;0;0;0;14;3
Sjælland;4-3-2020;M;1;0;1;0;15;4
Hovedstaden;5-3-2020;F;4;1;1;1;19;5
Hovedstaden;5-3-2020;M;6;1;2;2;25;7
Nordjylland;6-3-2020;M;1;0;0;2;26;7
Sjælland;6-3-2020;M;1;0;1;2;27;8
Hovedstaden;7-3-2020;F;5;0;1;2;32;9
Hovedstaden;7-3-2020;M;3;0;1;2;35;10
Midtjylland;7-3-2020;M;1;0;0;2;36;10
Hovedstaden;8-3-2020;F;8;0;0;2;44;10
Midtjylland;8-3-2020;F;6;0;0;2;50;10
Sjælland;8-3-2020;F;2;0;1;2;52;11
Syddanmark;8-3-2020;F;1;0;0;2;53;11
Hovedstaden;8-3-2020;M;4;0;1;2;57;12
Midtjylland;8-3-2020;M;16;0;0;2;73;12
Nordjylland;8-3-2020;M;1;0;0;2;74;12
Sjælland;8-3-2020;M;2;0;0;2;76;12
Syddanmark;8-3-2020;M;8;0;0;2;84;12
Hovedstaden;9-3-2020;F;27;0;3;2;111;15
Midtjylland;9-3-2020;F;10;0;1;2;121;16
Nordjylland;9-3-2020;F;2;0;0;2;123;16
Sjælland;9-3-2020;F;7;0;4;2;130;20
Syddanmark;9-3-2020;F;15;0;1;2;145;21
Hovedstaden;9-3-2020;M;44;0;4;2;189;25
Midtjylland;9-3-2020;M;35;0;2;2;224;27
Nordjylland;9-3-2020;M;6;0;0;2;230;27
Sjælland;9-3-2020;M;30;0;4;2;260;31
Syddanmark;9-3-2020;M;34;0;1;2;294;32
Hovedstaden;10-3-2020;F;46;0;4;2;340;36
Midtjylland;10-3-2020;F;18;0;1;2;358;37
Nordjylland;10-3-2020;F;4;0;1;2;362;38
Sjælland;10-3-2020;F;6;0;2;2;368;40
Syddanmark;10-3-2020;F;8;0;1;2;376;41
Hovedstaden;10-3-2020;M;70;1;3;3;446;44
Midtjylland;10-3-2020;M;54;1;4;4;500;48
Nordjylland;10-3-2020;M;9;0;0;4;509;48
Sjælland;10-3-2020;M;21;0;4;4;530;52
Syddanmark;10-3-2020;M;19;0;1;4;549;53
Hovedstaden;11-3-2020;F;31;0;2;4;580;55
Midtjylland;11-3-2020;F;11;1;1;5;591;56
Nordjylland;11-3-2020;F;3;0;0;5;594;56
Sjælland;11-3-2020;F;12;0;1;5;606;57
Syddanmark;11-3-2020;F;16;0;1;5;622;58
Hovedstaden;11-3-2020;M;57;0;3;5;679;61
Midtjylland;11-3-2020;M;14;1;1;6;693;62
Nordjylland;11-3-2020;M;20;0;0;6;713;62
Sjælland;11-3-2020;M;15;0;5;6;728;67
Syddanmark;11-3-2020;M;27;0;1;6;755;68
Hovedstaden;12-3-2020;F;9;1;3;7;764;71
Midtjylland;12-3-2020;F;2;0;2;7;766;73
Nordjylland;12-3-2020;F;1;0;1;7;767;74
Sjælland;12-3-2020;F;1;1;1;8;768;75
Syddanmark;12-3-2020;F;5;0;2;8;773;77
Hovedstaden;12-3-2020;M;9;0;3;8;782;80
Midtjylland;12-3-2020;M;6;0;4;8;788;84
Sjælland;12-3-2020;M;5;0;3;8;793;87
Syddanmark;12-3-2020;M;3;0;0;8;796;87
Hovedstaden;13-3-2020;F;5;0;1;8;801;88
Midtjylland;13-3-2020;F;2;0;1;8;803;89
Sjælland;13-3-2020;F;1;0;1;8;804;90
Syddanmark;13-3-2020;F;1;1;1;9;805;91
Hovedstaden;13-3-2020;M;16;2;8;11;821;99
Midtjylland;13-3-2020;M;5;1;5;12;826;104
Nordjylland;13-3-2020;M;1;0;1;12;827;105
Sjælland;13-3-2020;M;2;0;1;12;829;106
Hovedstaden;14-3-2020;F;8;1;3;13;837;109
Midtjylland;14-3-2020;F;4;0;1;13;841;110
Nordjylland;14-3-2020;F;2;0;2;13;843;112
Sjælland;14-3-2020;F;3;0;3;13;846;115
Syddanmark;14-3-2020;F;2;0;1;13;848;116
Hovedstaden;14-3-2020;M;8;2;6;15;856;122
Midtjylland;14-3-2020;M;2;0;1;15;858;123
Nordjylland;14-3-2020;M;1;0;1;15;859;124
Sjælland;14-3-2020;M;4;1;1;16;863;125
Syddanmark;14-3-2020;M;3;0;2;16;866;127
Hovedstaden;15-3-2020;F;8;1;4;17;874;131
Midtjylland;15-3-2020;F;3;1;2;18;877;133
Nordjylland;15-3-2020;F;1;0;1;18;878;134
Sjælland;15-3-2020;F;6;0;2;18;884;136
Syddanmark;15-3-2020;F;1;0;1;18;885;137
Hovedstaden;15-3-2020;M;17;2;12;20;902;149
Midtjylland;15-3-2020;M;1;0;0;20;903;149
Nordjylland;15-3-2020;M;2;0;2;20;905;151
Sjælland;15-3-2020;M;4;2;3;22;909;154
Syddanmark;15-3-2020;M;2;0;2;22;911;156
Hovedstaden;16-3-2020;F;27;1;10;23;938;166
Midtjylland;16-3-2020;F;1;0;1;23;939;167
Sjælland;16-3-2020;F;9;1;7;24;948;174
Hovedstaden;16-3-2020;M;23;6;18;30;971;192
Midtjylland;16-3-2020;M;1;1;1;31;972;193
Nordjylland;16-3-2020;M;1;0;1;31;973;194
Sjælland;16-3-2020;M;6;1;5;32;979;199
Syddanmark;16-3-2020;M;6;2;6;34;985;205
Hovedstaden;17-3-2020;F;23;2;10;36;1008;215
Midtjylland;17-3-2020;F;1;0;1;36;1009;216
Nordjylland;17-3-2020;F;2;0;2;36;1011;218
Sjælland;17-3-2020;F;4;1;4;37;1015;222
Syddanmark;17-3-2020;F;3;0;3;37;1018;225
Hovedstaden;17-3-2020;M;26;7;19;44;1044;244
Midtjylland;17-3-2020;M;6;1;5;45;1050;249
Nordjylland;17-3-2020;M;2;1;2;46;1052;251
Sjælland;17-3-2020;M;6;2;6;48;1058;257
Syddanmark;17-3-2020;M;3;1;2;49;1061;259
Hovedstaden;18-3-2020;F;16;2;8;51;1077;267
Midtjylland;18-3-2020;F;8;0;4;51;1085;271
Nordjylland;18-3-2020;F;3;0;2;51;1088;273
Sjælland;18-3-2020;F;6;0;5;51;1094;278
Syddanmark;18-3-2020;F;1;0;1;51;1095;279
Hovedstaden;18-3-2020;M;32;7;16;58;1127;295
Midtjylland;18-3-2020;M;3;1;1;59;1130;296
Nordjylland;18-3-2020;M;3;1;2;60;1133;298
Sjælland;18-3-2020;M;8;3;8;63;1141;306
Syddanmark;18-3-2020;M;3;1;2;64;1144;308
Hovedstaden;19-3-2020;F;30;1;12;65;1174;320
Midtjylland;19-3-2020;F;19;0;3;65;1193;323
Nordjylland;19-3-2020;F;2;0;2;65;1195;325
Sjælland;19-3-2020;F;2;0;1;65;1197;326
Syddanmark;19-3-2020;F;8;0;0;65;1205;326
Hovedstaden;19-3-2020;M;25;5;15;70;1230;341
Midtjylland;19-3-2020;M;5;0;1;70;1235;342
Nordjylland;19-3-2020;M;3;0;3;70;1238;345
Sjælland;19-3-2020;M;4;1;2;71;1242;347
Syddanmark;19-3-2020;M;8;0;6;71;1250;353
Hovedstaden;20-3-2020;F;32;4;17;75;1282;370
Midtjylland;20-3-2020;F;3;0;3;75;1285;373
Nordjylland;20-3-2020;F;2;0;0;75;1287;373
Sjælland;20-3-2020;F;8;1;5;76;1295;378
Syddanmark;20-3-2020;F;6;0;3;76;1301;381
Hovedstaden;20-3-2020;M;23;3;15;79;1324;396
Midtjylland;20-3-2020;M;6;0;2;79;1330;398
Nordjylland;20-3-2020;M;3;1;2;80;1333;400
Sjælland;20-3-2020;M;11;2;10;82;1344;410
Syddanmark;20-3-2020;M;8;0;7;82;1352;417
Hovedstaden;21-3-2020;F;15;2;6;84;1367;423
Midtjylland;21-3-2020;F;2;0;2;84;1369;425
Nordjylland;21-3-2020;F;1;0;1;84;1370;426
Sjælland;21-3-2020;F;5;0;4;84;1375;430
Syddanmark;21-3-2020;F;3;0;1;84;1378;431
Hovedstaden;21-3-2020;M;13;1;7;85;1391;438
Midtjylland;21-3-2020;M;3;0;3;85;1394;441
Sjælland;21-3-2020;M;3;1;2;86;1397;443
Syddanmark;21-3-2020;M;3;0;3;86;1400;446
Hovedstaden;22-3-2020;F;15;2;11;88;1415;457
Midtjylland;22-3-2020;F;3;0;3;88;1418;460
Nordjylland;22-3-2020;F;1;1;1;89;1419;461
Sjælland;22-3-2020;F;5;1;4;90;1424;465
Syddanmark;22-3-2020;F;1;0;1;90;1425;466
Hovedstaden;22-3-2020;M;20;5;10;95;1445;476
Midtjylland;22-3-2020;M;6;0;5;95;1451;481
Nordjylland;22-3-2020;M;1;0;1;95;1452;482
Sjælland;22-3-2020;M;6;2;5;97;1458;487
Syddanmark;22-3-2020;M;4;0;2;97;1462;489
Hovedstaden;23-3-2020;F;38;2;17;99;1500;506
Midtjylland;23-3-2020;F;11;0;9;99;1511;515
Nordjylland;23-3-2020;F;6;1;2;100;1517;517
Sjælland;23-3-2020;F;5;0;2;100;1522;519
Syddanmark;23-3-2020;F;1;0;0;100;1523;519
Hovedstaden;23-3-2020;M;34;3;21;103;1557;540
Midtjylland;23-3-2020;M;10;2;9;105;1567;549
Nordjylland;23-3-2020;M;4;0;4;105;1571;553
Sjælland;23-3-2020;M;12;3;8;108;1583;561
Syddanmark;23-3-2020;M;10;2;10;110;1593;571
Hovedstaden;24-3-2020;F;35;4;12;114;1628;583
Midtjylland;24-3-2020;F;7;0;5;114;1635;588
Nordjylland;24-3-2020;F;1;0;1;114;1636;589
Sjælland;24-3-2020;F;5;0;2;114;1641;591
Syddanmark;24-3-2020;F;11;0;7;114;1652;598
Hovedstaden;24-3-2020;M;39;4;27;118;1691;625
Midtjylland;24-3-2020;M;9;2;8;120;1700;633
Nordjylland;24-3-2020;M;6;0;6;120;1706;639
Sjælland;24-3-2020;M;13;3;9;123;1719;648
Syddanmark;24-3-2020;M;12;0;7;123;1731;655
Hovedstaden;25-3-2020;F;40;5;18;128;1771;673
Midtjylland;25-3-2020;F;8;0;2;128;1779;675
Nordjylland;25-3-2020;F;3;0;2;128;1782;677
Sjælland;25-3-2020;F;15;0;11;128;1797;688
Syddanmark;25-3-2020;F;8;0;3;128;1805;691
Hovedstaden;25-3-2020;M;33;9;23;137;1838;714
Midtjylland;25-3-2020;M;14;1;10;138;1852;724
Nordjylland;25-3-2020;M;5;1;4;139;1857;728
Sjælland;25-3-2020;M;14;4;11;143;1871;739
Syddanmark;25-3-2020;M;11;2;7;145;1882;746
Hovedstaden;26-3-2020;F;53;8;18;153;1935;764
Midtjylland;26-3-2020;F;14;3;6;156;1949;770
Nordjylland;26-3-2020;F;7;0;5;156;1956;775
Sjælland;26-3-2020;F;13;1;9;157;1969;784
Syddanmark;26-3-2020;F;10;0;4;157;1979;788
Hovedstaden;26-3-2020;M;36;5;23;162;2015;811
Midtjylland;26-3-2020;M;13;1;9;163;2028;820
Nordjylland;26-3-2020;M;5;0;3;163;2033;823
Sjælland;26-3-2020;M;6;2;3;165;2039;826
Syddanmark;26-3-2020;M;13;1;5;166;2052;831
Hovedstaden;27-3-2020;F;70;1;18;167;2122;849
Midtjylland;27-3-2020;F;11;0;1;167;2133;850
Nordjylland;27-3-2020;F;7;0;3;167;2140;853
Sjælland;27-3-2020;F;16;2;7;169;2156;860
Syddanmark;27-3-2020;F;14;0;6;169;2170;866
Hovedstaden;27-3-2020;M;51;4;27;173;2221;893
Midtjylland;27-3-2020;M;14;1;10;174;2235;903
Nordjylland;27-3-2020;M;3;0;0;174;2238;903
Sjælland;27-3-2020;M;12;0;8;174;2250;911
Syddanmark;27-3-2020;M;17;2;13;176;2267;924
Hovedstaden;28-3-2020;F;68;3;19;179;2335;943
Midtjylland;28-3-2020;F;12;0;2;179;2347;945
Nordjylland;28-3-2020;F;5;0;1;179;2352;946
Sjælland;28-3-2020;F;13;1;8;180;2365;954
Syddanmark;28-3-2020;F;14;1;10;181;2379;964
Hovedstaden;28-3-2020;M;53;8;25;189;2432;989
Midtjylland;28-3-2020;M;9;3;7;192;2441;996
Nordjylland;28-3-2020;M;6;1;4;193;2447;1000
Sjælland;28-3-2020;M;11;2;10;195;2458;1010
Syddanmark;28-3-2020;M;9;0;7;195;2467;1017
Hovedstaden;29-3-2020;F;51;3;14;198;2518;1031
Midtjylland;29-3-2020;F;3;1;2;199;2521;1033
Nordjylland;29-3-2020;F;4;2;1;201;2525;1034
Sjælland;29-3-2020;F;7;1;6;202;2532;1040
Syddanmark;29-3-2020;F;5;0;5;202;2537;1045
Hovedstaden;29-3-2020;M;32;1;8;203;2569;1053
Midtjylland;29-3-2020;M;5;1;3;204;2574;1056
Nordjylland;29-3-2020;M;5;1;3;205;2579;1059
Sjælland;29-3-2020;M;8;3;8;208;2587;1067
Syddanmark;29-3-2020;M;7;0;4;208;2594;1071
Hovedstaden;30-3-2020;F;97;9;24;217;2691;1095
Midtjylland;30-3-2020;F;25;2;4;219;2716;1099
Nordjylland;30-3-2020;F;8;0;2;219;2724;1101
Sjælland;30-3-2020;F;37;3;6;222;2761;1107
Syddanmark;30-3-2020;F;24;1;7;223;2785;1114
Hovedstaden;30-3-2020;M;64;4;22;227;2849;1136
Midtjylland;30-3-2020;M;16;2;6;229;2865;1142
Nordjylland;30-3-2020;M;3;0;0;229;2868;1142
Sjælland;30-3-2020;M;19;3;9;232;2887;1151
Syddanmark;30-3-2020;M;16;1;4;233;2903;1155
Hovedstaden;31-3-2020;F;74;8;21;241;2977;1176
Midtjylland;31-3-2020;F;39;0;6;241;3016;1182
Nordjylland;31-3-2020;F;15;2;2;243;3031;1184
Sjælland;31-3-2020;F;19;1;6;244;3050;1190
Syddanmark;31-3-2020;F;11;1;2;245;3061;1192
Hovedstaden;31-3-2020;M;50;3;16;248;3111;1208
Midtjylland;31-3-2020;M;11;3;7;251;3122;1215
Nordjylland;31-3-2020;M;3;1;0;252;3125;1215
Sjælland;31-3-2020;M;19;1;3;253;3144;1218
Syddanmark;31-3-2020;M;13;2;4;255;3157;1222
Hovedstaden;1-4-2020;F;89;6;15;261;3246;1237
Midtjylland;1-4-2020;F;40;2;4;263;3286;1241
Nordjylland;1-4-2020;F;13;1;2;264;3299;1243
Sjælland;1-4-2020;F;21;0;7;264;3320;1250
Syddanmark;1-4-2020;F;26;2;5;266;3346;1255
Hovedstaden;1-4-2020;M;51;2;12;268;3397;1267
Midtjylland;1-4-2020;M;14;1;4;269;3411;1271
Nordjylland;1-4-2020;M;3;0;3;269;3414;1274
Sjælland;1-4-2020;M;12;0;2;269;3426;1276
Syddanmark;1-4-2020;M;10;1;4;270;3436;1280
Hovedstaden;2-4-2020;F;120;3;20;273;3556;1300
Midtjylland;2-4-2020;F;36;1;4;274;3592;1304
Nordjylland;2-4-2020;F;18;0;1;274;3610;1305
Sjælland;2-4-2020;F;41;4;6;278;3651;1311
Syddanmark;2-4-2020;F;33;1;6;279;3684;1317
Hovedstaden;2-4-2020;M;66;5;17;284;3750;1334
Midtjylland;2-4-2020;M;14;1;3;285;3764;1337
Nordjylland;2-4-2020;M;8;1;6;286;3772;1343
Sjælland;2-4-2020;M;24;0;7;286;3796;1350
Syddanmark;2-4-2020;M;20;1;2;287;3816;1352
Hovedstaden;3-4-2020;F;169;5;20;292;3985;1372
Midtjylland;3-4-2020;F;46;0;7;292;4031;1379
Nordjylland;3-4-2020;F;19;1;7;293;4050;1386
Sjælland;3-4-2020;F;34;1;2;294;4084;1388
Syddanmark;3-4-2020;F;40;0;3;294;4124;1391
Hovedstaden;3-4-2020;M;89;6;18;300;4213;1409
Midtjylland;3-4-2020;M;25;2;4;302;4238;1413
Nordjylland;3-4-2020;M;9;1;2;303;4247;1415
Sjælland;3-4-2020;M;18;0;4;303;4265;1419
Syddanmark;3-4-2020;M;22;0;7;303;4287;1426
Hovedstaden;4-4-2020;F;127;2;12;305;4414;1438
Midtjylland;4-4-2020;F;19;1;4;306;4433;1442
Nordjylland;4-4-2020;F;2;0;0;306;4435;1442
Sjælland;4-4-2020;F;21;1;5;307;4456;1447
Syddanmark;4-4-2020;F;12;0;1;307;4468;1448
Hovedstaden;4-4-2020;M;86;6;22;313;4554;1470
Midtjylland;4-4-2020;M;11;3;4;316;4565;1474
Nordjylland;4-4-2020;M;6;1;4;317;4571;1478
Sjælland;4-4-2020;M;5;1;3;318;4576;1481
Syddanmark;4-4-2020;M;4;0;1;318;4580;1482
Hovedstaden;5-4-2020;F;64;6;16;324;4644;1498
Midtjylland;5-4-2020;F;18;0;4;324;4662;1502
Nordjylland;5-4-2020;F;3;1;0;325;4665;1502
Sjælland;5-4-2020;F;13;0;2;325;4678;1504
Syddanmark;5-4-2020;F;9;0;1;325;4687;1505
Hovedstaden;5-4-2020;M;38;4;8;329;4725;1513
Midtjylland;5-4-2020;M;2;0;0;329;4727;1513
Nordjylland;5-4-2020;M;2;0;1;329;4729;1514
Sjælland;5-4-2020;M;5;0;1;329;4734;1515
Syddanmark;5-4-2020;M;3;1;2;330;4737;1517
Hovedstaden;6-4-2020;F;128;4;18;334;4865;1535
Midtjylland;6-4-2020;F;44;1;4;335;4909;1539
Nordjylland;6-4-2020;F;10;0;0;335;4919;1539
Sjælland;6-4-2020;F;52;2;9;337;4971;1548
Syddanmark;6-4-2020;F;25;1;1;338;4996;1549
Hovedstaden;6-4-2020;M;93;4;12;342;5089;1561
Midtjylland;6-4-2020;M;27;2;4;344;5116;1565
Nordjylland;6-4-2020;M;11;0;1;344;5127;1566
Sjælland;6-4-2020;M;11;0;2;344;5138;1568
Syddanmark;6-4-2020;M;22;0;5;344;5160;1573
Hovedstaden;7-4-2020;F;105;6;20;350;5265;1593
Midtjylland;7-4-2020;F;41;1;4;351;5306;1597
Nordjylland;7-4-2020;F;3;0;0;351;5309;1597
Sjælland;7-4-2020;F;30;0;3;351;5339;1600
Syddanmark;7-4-2020;F;24;0;4;351;5363;1604
Hovedstaden;7-4-2020;M;77;3;12;354;5440;1616
Midtjylland;7-4-2020;M;25;2;2;356;5465;1618
Nordjylland;7-4-2020;M;6;0;1;356;5471;1619
Sjælland;7-4-2020;M;23;0;4;356;5494;1623
Syddanmark;7-4-2020;M;11;0;0;356;5505;1623
Hovedstaden;8-4-2020;F;110;2;12;358;5615;1635
Midtjylland;8-4-2020;F;29;1;3;359;5644;1638
Nordjylland;8-4-2020;F;6;0;0;359;5650;1638
Sjælland;8-4-2020;F;36;0;6;359;5686;1644
Syddanmark;8-4-2020;F;16;1;0;360;5702;1644
Hovedstaden;8-4-2020;M;56;3;8;363;5758;1652
Midtjylland;8-4-2020;M;21;0;3;363;5779;1655
Nordjylland;8-4-2020;M;1;0;0;363;5780;1655
Sjælland;8-4-2020;M;16;2;5;365;5796;1660
Syddanmark;8-4-2020;M;3;0;0;365;5799;1660
Hovedstaden;9-4-2020;F;52;2;11;367;5851;1671
Midtjylland;9-4-2020;F;12;0;2;367;5863;1673
Nordjylland;9-4-2020;F;4;0;0;367;5867;1673
Sjælland;9-4-2020;F;10;1;5;368;5877;1678
Syddanmark;9-4-2020;F;8;0;2;368;5885;1680
Hovedstaden;9-4-2020;M;22;1;2;369;5907;1682
Midtjylland;9-4-2020;M;11;1;3;370;5918;1685
Nordjylland;9-4-2020;M;4;0;0;370;5922;1685
Sjælland;9-4-2020;M;9;1;3;371;5931;1688
Syddanmark;9-4-2020;M;4;0;0;371;5935;1688
Hovedstaden;10-4-2020;F;54;1;4;372;5989;1692
Midtjylland;10-4-2020;F;12;0;2;372;6001;1694
Nordjylland;10-4-2020;F;4;0;1;372;6005;1695
Sjælland;10-4-2020;F;16;0;1;372;6021;1696
Syddanmark;10-4-2020;F;1;0;0;372;6022;1696
Hovedstaden;10-4-2020;M;34;1;3;373;6056;1699
Midtjylland;10-4-2020;M;5;0;1;373;6061;1700
Nordjylland;10-4-2020;M;3;0;1;373;6064;1701
Sjælland;10-4-2020;M;5;1;5;374;6069;1706
Syddanmark;10-4-2020;M;6;0;1;374;6075;1707
Hovedstaden;11-4-2020;F;34;2;6;376;6109;1713
Midtjylland;11-4-2020;F;23;1;3;377;6132;1716
Nordjylland;11-4-2020;F;2;0;1;377;6134;1717
Sjælland;11-4-2020;F;8;1;4;378;6142;1721
Syddanmark;11-4-2020;F;8;0;2;378;6150;1723
Hovedstaden;11-4-2020;M;40;3;8;381;6190;1731
Midtjylland;11-4-2020;M;11;2;4;383;6201;1735
Sjælland;11-4-2020;M;7;0;2;383;6208;1737
Syddanmark;11-4-2020;M;6;1;3;384;6214;1740
Hovedstaden;12-4-2020;F;64;3;8;387;6278;1748
Midtjylland;12-4-2020;F;13;2;2;389;6291;1750
Nordjylland;12-4-2020;F;5;0;1;389;6296;1751
Sjælland;12-4-2020;F;17;0;4;389;6313;1755
Syddanmark;12-4-2020;F;7;0;1;389;6320;1756
Hovedstaden;12-4-2020;M;31;1;3;390;6351;1759
Midtjylland;12-4-2020;M;8;0;1;390;6359;1760
Nordjylland;12-4-2020;M;3;0;2;390;6362;1762
Sjælland;12-4-2020;M;2;0;0;390;6364;1762
Syddanmark;12-4-2020;M;6;0;1;390;6370;1763
Hovedstaden;13-4-2020;F;57;3;5;393;6427;1768
Midtjylland;13-4-2020;F;20;0;2;393;6447;1770
Nordjylland;13-4-2020;F;4;0;0;393;6451;1770
Sjælland;13-4-2020;F;11;1;3;394;6462;1773
Syddanmark;13-4-2020;F;4;0;1;394;6466;1774
Hovedstaden;13-4-2020;M;39;4;13;398;6505;1787
Midtjylland;13-4-2020;M;11;0;2;398;6516;1789
Nordjylland;13-4-2020;M;1;0;0;398;6517;1789
Sjælland;13-4-2020;M;7;1;5;399;6524;1794
Syddanmark;13-4-2020;M;2;0;1;399;6526;1795
Hovedstaden;14-4-2020;F;88;5;13;404;6614;1808
Midtjylland;14-4-2020;F;30;0;3;404;6644;1811
Nordjylland;14-4-2020;F;2;0;0;404;6646;1811
Sjælland;14-4-2020;F;35;0;4;404;6681;1815
Syddanmark;14-4-2020;F;17;1;2;405;6698;1817
Hovedstaden;14-4-2020;M;46;1;6;406;6744;1823
Midtjylland;14-4-2020;M;16;3;5;409;6760;1828
Sjælland;14-4-2020;M;16;1;3;410;6776;1831
Syddanmark;14-4-2020;M;8;0;0;410;6784;1831
Hovedstaden;15-4-2020;F;79;5;6;415;6863;1837
Midtjylland;15-4-2020;F;17;1;1;416;6880;1838
Nordjylland;15-4-2020;F;4;0;0;416;6884;1838
Sjælland;15-4-2020;F;20;0;5;416;6904;1843
Syddanmark;15-4-2020;F;8;0;1;416;6912;1844
Hovedstaden;15-4-2020;M;40;2;4;418;6952;1848
Midtjylland;15-4-2020;M;10;1;2;419;6962;1850
Nordjylland;15-4-2020;M;4;0;0;419;6966;1850
Sjælland;15-4-2020;M;10;2;5;421;6976;1855
Syddanmark;15-4-2020;M;6;0;1;421;6982;1856
Hovedstaden;16-4-2020;F;53;1;7;422;7035;1863
Midtjylland;16-4-2020;F;26;0;2;422;7061;1865
Nordjylland;16-4-2020;F;4;0;0;422;7065;1865
Sjælland;16-4-2020;F;16;2;5;424;7081;1870
Syddanmark;16-4-2020;F;8;0;1;424;7089;1871
Hovedstaden;16-4-2020;M;37;2;8;426;7126;1879
Midtjylland;16-4-2020;M;16;1;2;427;7142;1881
Nordjylland;16-4-2020;M;1;0;0;427;7143;1881
Sjælland;16-4-2020;M;8;0;0;427;7151;1881
Syddanmark;16-4-2020;M;9;0;1;427;7160;1882
Hovedstaden;17-4-2020;F;51;1;7;428;7211;1889
Midtjylland;17-4-2020;F;18;1;1;429;7229;1890
Nordjylland;17-4-2020;F;2;0;0;429;7231;1890
Sjælland;17-4-2020;F;29;2;7;431;7260;1897
Syddanmark;17-4-2020;F;8;0;2;431;7268;1899
Hovedstaden;17-4-2020;M;37;3;7;434;7305;1906
Midtjylland;17-4-2020;M;5;0;0;434;7310;1906
Nordjylland;17-4-2020;M;2;1;0;435;7312;1906
Sjælland;17-4-2020;M;14;1;4;436;7326;1910
Syddanmark;17-4-2020;M;2;0;0;436;7328;1910
Hovedstaden;18-4-2020;F;37;1;7;437;7365;1917
Midtjylland;18-4-2020;F;13;0;3;437;7378;1920
Nordjylland;18-4-2020;F;2;0;1;437;7380;1921
Sjælland;18-4-2020;F;15;1;2;438;7395;1923
Hovedstaden;18-4-2020;M;23;3;7;441;7418;1930
Midtjylland;18-4-2020;M;4;0;0;441;7422;1930
Sjælland;18-4-2020;M;7;2;4;443;7429;1934
Syddanmark;18-4-2020;M;3;0;0;443;7432;1934
Hovedstaden;19-4-2020;F;37;1;7;444;7469;1941
Midtjylland;19-4-2020;F;8;0;2;444;7477;1943
Sjælland;19-4-2020;F;19;0;4;444;7496;1947
Syddanmark;19-4-2020;F;3;0;0;444;7499;1947
Hovedstaden;19-4-2020;M;24;1;9;445;7523;1956
Midtjylland;19-4-2020;M;7;0;1;445;7530;1957
Nordjylland;19-4-2020;M;2;0;0;445;7532;1957
Sjælland;19-4-2020;M;10;3;7;448;7542;1964
Syddanmark;19-4-2020;M;1;0;0;448;7543;1964
Hovedstaden;20-4-2020;F;89;5;8;453;7632;1972
Midtjylland;20-4-2020;F;15;0;1;453;7647;1973
Nordjylland;20-4-2020;F;5;0;0;453;7652;1973
Sjælland;20-4-2020;F;26;1;7;454;7678;1980
Syddanmark;20-4-2020;F;3;0;0;454;7681;1980
Hovedstaden;20-4-2020;M;50;3;11;457;7731;1991
Midtjylland;20-4-2020;M;11;1;2;458;7742;1993
Nordjylland;20-4-2020;M;1;0;0;458;7743;1993
Sjælland;20-4-2020;M;10;1;5;459;7753;1998
Syddanmark;20-4-2020;M;3;2;2;461;7756;2000
Hovedstaden;21-4-2020;F;65;3;10;464;7821;2010
Midtjylland;21-4-2020;F;10;0;0;464;7831;2010
Nordjylland;21-4-2020;F;4;1;0;465;7835;2010
Sjælland;21-4-2020;F;31;1;7;466;7866;2017
Syddanmark;21-4-2020;F;7;0;1;466;7873;2018
Hovedstaden;21-4-2020;M;54;5;6;471;7927;2024
Midtjylland;21-4-2020;M;8;1;2;472;7935;2026
Nordjylland;21-4-2020;M;1;0;0;472;7936;2026
Sjælland;21-4-2020;M;15;1;7;473;7951;2033
Syddanmark;21-4-2020;M;5;0;0;473;7956;2033
Hovedstaden;22-4-2020;F;87;3;9;476;8043;2042
Midtjylland;22-4-2020;F;17;0;2;476;8060;2044
Nordjylland;22-4-2020;F;5;0;0;476;8065;2044
Sjælland;22-4-2020;F;22;2;4;478;8087;2048
Syddanmark;22-4-2020;F;1;0;0;478;8088;2048
Hovedstaden;22-4-2020;M;66;6;12;484;8154;2060
Midtjylland;22-4-2020;M;15;1;4;485;8169;2064
Sjælland;22-4-2020;M;12;1;3;486;8181;2067
Syddanmark;22-4-2020;M;1;0;0;486;8182;2067
Hovedstaden;23-4-2020;F;89;4;10;490;8271;2077
Midtjylland;23-4-2020;F;22;1;1;491;8293;2078
Nordjylland;23-4-2020;F;2;0;0;491;8295;2078
Sjælland;23-4-2020;F;30;1;6;492;8325;2084
Syddanmark;23-4-2020;F;4;0;0;492;8329;2084
Hovedstaden;23-4-2020;M;49;1;7;493;8378;2091
Midtjylland;23-4-2020;M;10;0;1;493;8388;2092
Nordjylland;23-4-2020;M;1;0;0;493;8389;2092
Sjælland;23-4-2020;M;20;0;7;493;8409;2099
Syddanmark;23-4-2020;M;4;0;0;493;8413;2099
Hovedstaden;24-4-2020;F;61;2;8;495;8474;2107
Midtjylland;24-4-2020;F;19;1;1;496;8493;2108
Sjælland;24-4-2020;F;23;2;5;498;8516;2113
Syddanmark;24-4-2020;F;2;0;0;498;8518;2113
Hovedstaden;24-4-2020;M;34;1;4;499;8552;2117
Midtjylland;24-4-2020;M;8;1;0;500;8560;2117
Nordjylland;24-4-2020;M;2;0;0;500;8562;2117
Sjælland;24-4-2020;M;12;1;3;501;8574;2120
Syddanmark;24-4-2020;M;3;0;0;501;8577;2120
Hovedstaden;25-4-2020;F;38;1;5;502;8615;2125
Midtjylland;25-4-2020;F;22;1;0;503;8637;2125
Nordjylland;25-4-2020;F;4;0;1;503;8641;2126
Sjælland;25-4-2020;F;14;1;4;504;8655;2130
Syddanmark;25-4-2020;F;3;0;0;504;8658;2130
Hovedstaden;25-4-2020;M;31;2;6;506;8689;2136
Midtjylland;25-4-2020;M;7;0;1;506;8696;2137
Nordjylland;25-4-2020;M;1;0;0;506;8697;2137
Sjælland;25-4-2020;M;9;2;2;508;8706;2139
Syddanmark;25-4-2020;M;5;0;0;508;8711;2139
Hovedstaden;26-4-2020;F;42;1;12;509;8753;2151
Midtjylland;26-4-2020;F;10;0;0;509;8763;2151
Nordjylland;26-4-2020;F;4;0;0;509;8767;2151
Sjælland;26-4-2020;F;13;0;2;509;8780;2153
Syddanmark;26-4-2020;F;4;0;0;509;8784;2153
Hovedstaden;26-4-2020;M;33;3;7;512;8817;2160
Midtjylland;26-4-2020;M;5;0;2;512;8822;2162
Sjælland;26-4-2020;M;5;1;1;513;8827;2163
Syddanmark;26-4-2020;M;3;0;0;513;8830;2163
Hovedstaden;27-4-2020;F;70;1;2;514;8900;2165
Midtjylland;27-4-2020;F;9;0;1;514;8909;2166
Nordjylland;27-4-2020;F;3;0;0;514;8912;2166
Sjælland;27-4-2020;F;36;4;5;518;8948;2171
Syddanmark;27-4-2020;F;1;0;0;518;8949;2171
Hovedstaden;27-4-2020;M;59;2;7;520;9008;2178
Midtjylland;27-4-2020;M;9;0;2;520;9017;2180
Nordjylland;27-4-2020;M;2;0;0;520;9019;2180
Sjælland;27-4-2020;M;25;5;5;525;9044;2185
Syddanmark;27-4-2020;M;3;0;0;525;9047;2185
Hovedstaden;28-4-2020;F;51;2;7;527;9098;2192
Midtjylland;28-4-2020;F;17;0;0;527;9115;2192
Sjælland;28-4-2020;F;22;0;0;527;9137;2192
Hovedstaden;28-4-2020;M;32;0;3;527;9169;2195
Midtjylland;28-4-2020;M;7;0;0;527;9176;2195
Sjælland;28-4-2020;M;7;0;0;527;9183;2195
Hovedstaden;29-4-2020;F;50;2;6;529;9233;2201
Midtjylland;29-4-2020;F;10;1;1;530;9243;2202
Nordjylland;29-4-2020;F;1;0;0;530;9244;2202
Sjælland;29-4-2020;F;16;0;1;530;9260;2203
Syddanmark;29-4-2020;F;4;0;0;530;9264;2203
Hovedstaden;29-4-2020;M;42;4;11;534;9306;2214
Midtjylland;29-4-2020;M;7;0;0;534;9313;2214
Nordjylland;29-4-2020;M;2;0;0;534;9315;2214
Sjælland;29-4-2020;M;5;1;2;535;9320;2216
Syddanmark;29-4-2020;M;2;0;0;535;9322;2216
Hovedstaden;30-4-2020;F;62;0;6;535;9384;2222
Midtjylland;30-4-2020;F;6;0;1;535;9390;2223
Nordjylland;30-4-2020;F;3;0;0;535;9393;2223
Sjælland;30-4-2020;F;23;0;3;535;9416;2226
Syddanmark;30-4-2020;F;1;0;0;535;9417;2226
Hovedstaden;30-4-2020;M;33;0;5;535;9450;2231
Midtjylland;30-4-2020;M;7;0;0;535;9457;2231
Nordjylland;30-4-2020;M;2;0;1;535;9459;2232
Sjælland;30-4-2020;M;8;0;0;535;9467;2232
Syddanmark;30-4-2020;M;1;0;0;535;9468;2232
Hovedstaden;1-5-2020;F;58;2;3;537;9526;2235
Midtjylland;1-5-2020;F;5;0;0;537;9531;2235
Nordjylland;1-5-2020;F;10;0;0;537;9541;2235
Sjælland;1-5-2020;F;15;1;1;538;9556;2236
Syddanmark;1-5-2020;F;2;0;0;538;9558;2236
Hovedstaden;1-5-2020;M;25;0;2;538;9583;2238
Midtjylland;1-5-2020;M;11;0;1;538;9594;2239
Nordjylland;1-5-2020;M;9;0;0;538;9603;2239
Sjælland;1-5-2020;M;10;1;2;539;9613;2241
Syddanmark;1-5-2020;M;3;0;1;539;9616;2242
Hovedstaden;2-5-2020;F;31;0;2;539;9647;2244
Midtjylland;2-5-2020;F;12;0;3;539;9659;2247
Nordjylland;2-5-2020;F;1;0;0;539;9660;2247
Sjælland;2-5-2020;F;17;0;1;539;9677;2248
Syddanmark;2-5-2020;F;4;0;0;539;9681;2248
Hovedstaden;2-5-2020;M;27;1;4;540;9708;2252
Midtjylland;2-5-2020;M;8;0;1;540;9716;2253
Nordjylland;2-5-2020;M;1;0;0;540;9717;2253
Sjælland;2-5-2020;M;12;1;1;541;9729;2254
Syddanmark;2-5-2020;M;2;0;0;541;9731;2254
Hovedstaden;3-5-2020;F;33;0;7;541;9764;2261
Midtjylland;3-5-2020;F;4;0;1;541;9768;2262
Nordjylland;3-5-2020;F;1;0;0;541;9769;2262
Sjælland;3-5-2020;F;6;0;2;541;9775;2264
Syddanmark;3-5-2020;F;4;0;1;541;9779;2265
Hovedstaden;3-5-2020;M;17;2;2;543;9796;2267
Midtjylland;3-5-2020;M;6;0;1;543;9802;2268
Nordjylland;3-5-2020;M;1;0;0;543;9803;2268
Sjælland;3-5-2020;M;5;1;3;544;9808;2271
Syddanmark;3-5-2020;M;1;0;0;544;9809;2271
Hovedstaden;4-5-2020;F;50;0;3;544;9859;2274
Midtjylland;4-5-2020;F;5;0;1;544;9864;2275
Sjælland;4-5-2020;F;21;1;3;545;9885;2278
Syddanmark;4-5-2020;F;3;0;0;545;9888;2278
Hovedstaden;4-5-2020;M;29;0;3;545;9917;2281
Midtjylland;4-5-2020;M;3;0;1;545;9920;2282
Sjælland;4-5-2020;M;8;0;3;545;9928;2285
Syddanmark;4-5-2020;M;1;0;0;545;9929;2285
Hovedstaden;5-5-2020;F;32;1;4;546;9961;2289
Midtjylland;5-5-2020;F;5;0;0;546;9966;2289
Nordjylland;5-5-2020;F;2;0;0;546;9968;2289
Sjælland;5-5-2020;F;20;2;4;548;9988;2293
Syddanmark;5-5-2020;F;4;0;0;548;9992;2293
Hovedstaden;5-5-2020;M;40;2;5;550;10032;2298
Midtjylland;5-5-2020;M;3;0;0;550;10035;2298
Sjælland;5-5-2020;M;15;0;5;550;10050;2303
Syddanmark;5-5-2020;M;1;0;0;550;10051;2303
Hovedstaden;6-5-2020;F;55;0;1;550;10106;2304
Midtjylland;6-5-2020;F;2;0;0;550;10108;2304
Sjælland;6-5-2020;F;9;0;0;550;10117;2304
Syddanmark;6-5-2020;F;2;0;0;550;10119;2304
Hovedstaden;6-5-2020;M;27;0;4;550;10146;2308
Midtjylland;6-5-2020;M;4;0;0;550;10150;2308
Sjælland;6-5-2020;M;6;0;2;550;10156;2310
Hovedstaden;7-5-2020;F;44;0;2;550;10200;2312
Midtjylland;7-5-2020;F;5;0;0;550;10205;2312
Sjælland;7-5-2020;F;19;0;3;550;10224;2315
Syddanmark;7-5-2020;F;1;0;0;550;10225;2315
Hovedstaden;7-5-2020;M;32;0;4;550;10257;2319
Midtjylland;7-5-2020;M;5;0;0;550;10262;2319
Nordjylland;7-5-2020;M;1;0;0;550;10263;2319
Sjælland;7-5-2020;M;13;2;4;552;10276;2323
Syddanmark;7-5-2020;M;2;0;0;552;10278;2323
Hovedstaden;8-5-2020;F;31;3;4;555;10309;2327
Midtjylland;8-5-2020;F;4;0;0;555;10313;2327
Sjælland;8-5-2020;F;4;0;0;555;10317;2327
Syddanmark;8-5-2020;F;1;0;0;555;10318;2327
Hovedstaden;8-5-2020;M;21;1;4;556;10339;2331
Midtjylland;8-5-2020;M;1;0;0;556;10340;2331
Sjælland;8-5-2020;M;5;0;0;556;10345;2331
Syddanmark;8-5-2020;M;2;0;0;556;10347;2331
Hovedstaden;9-5-2020;F;24;1;5;557;10371;2336
Midtjylland;9-5-2020;F;2;0;2;557;10373;2338
Nordjylland;9-5-2020;F;1;0;0;557;10374;2338
Sjælland;9-5-2020;F;7;0;0;557;10381;2338
Hovedstaden;9-5-2020;M;24;1;5;558;10405;2343
Midtjylland;9-5-2020;M;2;0;0;558;10407;2343
Sjælland;9-5-2020;M;4;0;1;558;10411;2344
Hovedstaden;10-5-2020;F;20;0;2;558;10431;2346
Midtjylland;10-5-2020;F;2;0;0;558;10433;2346
Nordjylland;10-5-2020;F;2;0;0;558;10435;2346
Sjælland;10-5-2020;F;4;0;0;558;10439;2346
Syddanmark;10-5-2020;F;3;0;0;558;10442;2346
Hovedstaden;10-5-2020;M;18;0;2;558;10460;2348
Midtjylland;10-5-2020;M;1;0;0;558;10461;2348
Nordjylland;10-5-2020;M;2;0;0;558;10463;2348
Sjælland;10-5-2020;M;4;1;1;559;10467;2349
Syddanmark;10-5-2020;M;1;1;1;560;10468;2350
Hovedstaden;11-5-2020;F;28;0;4;560;10496;2354
Midtjylland;11-5-2020;F;2;0;1;560;10498;2355
Sjælland;11-5-2020;F;5;0;1;560;10503;2356
Syddanmark;11-5-2020;F;5;0;0;560;10508;2356
Hovedstaden;11-5-2020;M;22;0;1;560;10530;2357
Midtjylland;11-5-2020;M;1;0;0;560;10531;2357
Nordjylland;11-5-2020;M;1;0;0;560;10532;2357
Sjælland;11-5-2020;M;7;0;1;560;10539;2358
Syddanmark;11-5-2020;M;7;1;2;561;10546;2360
Hovedstaden;12-5-2020;F;20;0;4;561;10566;2364
Nordjylland;12-5-2020;F;1;0;0;561;10567;2364
Sjælland;12-5-2020;F;9;0;1;561;10576;2365
Syddanmark;12-5-2020;F;6;0;0;561;10582;2365
Hovedstaden;12-5-2020;M;15;1;1;562;10597;2366
Midtjylland;12-5-2020;M;1;0;0;562;10598;2366
Sjælland;12-5-2020;M;1;0;0;562;10599;2366
Syddanmark;12-5-2020;M;3;0;0;562;10602;2366
Hovedstaden;13-5-2020;F;26;1;1;563;10628;2367
Midtjylland;13-5-2020;F;3;0;1;563;10631;2368
Sjælland;13-5-2020;F;7;0;1;563;10638;2369
Syddanmark;13-5-2020;F;5;0;1;563;10643;2370
Hovedstaden;13-5-2020;M;15;0;0;563;10658;2370
Midtjylland;13-5-2020;M;1;0;0;563;10659;2370
Nordjylland;13-5-2020;M;1;0;0;563;10660;2370
Sjælland;13-5-2020;M;6;0;0;563;10666;2370
Syddanmark;13-5-2020;M;1;0;0;563;10667;2370
Hovedstaden;14-5-2020;F;22;0;2;563;10689;2372
Midtjylland;14-5-2020;F;1;0;0;563;10690;2372
Sjælland;14-5-2020;F;11;0;2;563;10701;2374
Syddanmark;14-5-2020;F;3;0;1;563;10704;2375
Hovedstaden;14-5-2020;M;13;0;2;563;10717;2377
Midtjylland;14-5-2020;M;3;0;0;563;10720;2377
Sjælland;14-5-2020;M;3;0;0;563;10723;2377
Syddanmark;14-5-2020;M;5;1;4;564;10728;2381
Hovedstaden;15-5-2020;F;26;1;2;565;10754;2383
Midtjylland;15-5-2020;F;4;0;0;565;10758;2383
Nordjylland;15-5-2020;F;1;0;1;565;10759;2384
Sjælland;15-5-2020;F;5;1;3;566;10764;2387
Syddanmark;15-5-2020;F;3;0;0;566;10767;2387
Hovedstaden;15-5-2020;M;32;0;3;566;10799;2390
Sjælland;15-5-2020;M;9;2;2;568;10808;2392
Syddanmark;15-5-2020;M;9;1;1;569;10817;2393
Hovedstaden;16-5-2020;F;8;0;0;569;10825;2393
Midtjylland;16-5-2020;F;3;0;1;569;10828;2394
Nordjylland;16-5-2020;F;1;0;0;569;10829;2394
Sjælland;16-5-2020;F;5;1;1;570;10834;2395
Syddanmark;16-5-2020;F;1;0;0;570;10835;2395
Hovedstaden;16-5-2020;M;10;0;0;570;10845;2395
Midtjylland;16-5-2020;M;1;0;0;570;10846;2395
Sjælland;16-5-2020;M;3;0;1;570;10849;2396
Syddanmark;16-5-2020;M;2;0;1;570;10851;2397
Hovedstaden;17-5-2020;F;18;0;2;570;10869;2399
Midtjylland;17-5-2020;F;5;0;2;570;10874;2401
Sjælland;17-5-2020;F;5;0;0;570;10879;2401
Syddanmark;17-5-2020;F;3;0;0;570;10882;2401
Hovedstaden;17-5-2020;M;13;0;1;570;10895;2402
Midtjylland;17-5-2020;M;3;0;0;570;10898;2402
Sjælland;17-5-2020;M;2;0;0;570;10900;2402
Syddanmark;17-5-2020;M;1;0;0;570;10901;2402
Hovedstaden;18-5-2020;F;31;1;3;571;10932;2405
Midtjylland;18-5-2020;F;4;0;2;571;10936;2407
Sjælland;18-5-2020;F;5;0;1;571;10941;2408
Syddanmark;18-5-2020;F;4;0;1;571;10945;2409
Hovedstaden;18-5-2020;M;23;1;1;572;10968;2410
Midtjylland;18-5-2020;M;3;0;1;572;10971;2411
Nordjylland;18-5-2020;M;1;0;0;572;10972;2411
Sjælland;18-5-2020;M;3;0;0;572;10975;2411
Syddanmark;18-5-2020;M;6;0;0;572;10981;2411
Hovedstaden;19-5-2020;F;23;0;2;572;11004;2413
Midtjylland;19-5-2020;F;1;0;1;572;11005;2414
Sjælland;19-5-2020;F;5;0;0;572;11010;2414
Syddanmark;19-5-2020;F;3;0;1;572;11013;2415
Hovedstaden;19-5-2020;M;18;1;1;573;11031;2416
Midtjylland;19-5-2020;M;4;0;0;573;11035;2416
Nordjylland;19-5-2020;M;2;0;0;573;11037;2416
Sjælland;19-5-2020;M;3;0;1;573;11040;2417
Syddanmark;19-5-2020;M;1;0;0;573;11041;2417
Hovedstaden;20-5-2020;F;27;2;4;575;11068;2421
Nordjylland;20-5-2020;F;1;0;0;575;11069;2421
Sjælland;20-5-2020;F;7;0;0;575;11076;2421
Syddanmark;20-5-2020;F;4;0;0;575;11080;2421
Hovedstaden;20-5-2020;M;25;2;3;577;11105;2424
Sjælland;20-5-2020;M;5;1;2;578;11110;2426
Hovedstaden;21-5-2020;F;11;0;1;578;11121;2427
Midtjylland;21-5-2020;F;1;0;1;578;11122;2428
Nordjylland;21-5-2020;F;1;0;1;578;11123;2429
Sjælland;21-5-2020;F;4;0;1;578;11127;2430
Hovedstaden;21-5-2020;M;13;0;2;578;11140;2432
Sjælland;21-5-2020;M;1;0;1;578;11141;2433
Hovedstaden;22-5-2020;F;29;3;7;581;11170;2440
Midtjylland;22-5-2020;F;1;0;0;581;11171;2440
Nordjylland;22-5-2020;F;2;0;0;581;11173;2440
Sjælland;22-5-2020;F;6;0;1;581;11179;2441
Syddanmark;22-5-2020;F;1;0;0;581;11180;2441
Hovedstaden;22-5-2020;M;19;1;4;582;11199;2445
Midtjylland;22-5-2020;M;2;0;1;582;11201;2446
Sjælland;22-5-2020;M;8;1;2;583;11209;2448
Syddanmark;22-5-2020;M;3;0;0;583;11212;2448
Hovedstaden;23-5-2020;F;14;0;2;583;11226;2450
Midtjylland;23-5-2020;F;1;0;0;583;11227;2450
Sjælland;23-5-2020;F;3;1;1;584;11230;2451
Hovedstaden;23-5-2020;M;15;0;3;584;11245;2454
Midtjylland;23-5-2020;M;1;0;1;584;11246;2455
Sjælland;23-5-2020;M;1;0;0;584;11247;2455
Hovedstaden;24-5-2020;F;15;0;2;584;11262;2457
Sjælland;24-5-2020;F;5;0;1;584;11267;2458
Syddanmark;24-5-2020;F;1;0;0;584;11268;2458
Hovedstaden;24-5-2020;M;13;0;3;584;11281;2461
Hovedstaden;25-5-2020;F;25;1;3;585;11306;2464
Midtjylland;25-5-2020;F;1;0;0;585;11307;2464
Sjælland;25-5-2020;F;2;0;0;585;11309;2464
Syddanmark;25-5-2020;F;2;0;1;585;11311;2465
Hovedstaden;25-5-2020;M;18;0;0;585;11329;2465
Nordjylland;25-5-2020;M;1;0;0;585;11330;2465
Sjælland;25-5-2020;M;3;0;0;585;11333;2465
Hovedstaden;26-5-2020;F;27;2;5;587;11360;2470
Nordjylland;26-5-2020;F;2;0;0;587;11362;2470
Sjælland;26-5-2020;F;7;0;0;587;11369;2470
Syddanmark;26-5-2020;F;3;0;2;587;11372;2472
Hovedstaden;26-5-2020;M;19;0;4;587;11391;2476
Midtjylland;26-5-2020;M;2;0;0;587;11393;2476
Syddanmark;26-5-2020;M;2;0;1;587;11395;2477
Hovedstaden;27-5-2020;F;24;1;3;588;11419;2480
Midtjylland;27-5-2020;F;1;0;0;588;11420;2480
Sjælland;27-5-2020;F;2;0;0;588;11422;2480
Hovedstaden;27-5-2020;M;18;1;5;589;11440;2485
Midtjylland;27-5-2020;M;1;0;0;589;11441;2485
Sjælland;27-5-2020;M;6;0;2;589;11447;2487
Hovedstaden;28-5-2020;F;19;0;2;589;11466;2489
Sjælland;28-5-2020;F;5;0;2;589;11471;2491
Syddanmark;28-5-2020;F;1;0;0;589;11472;2491
Hovedstaden;28-5-2020;M;9;1;3;590;11481;2494
Sjælland;28-5-2020;M;2;0;0;590;11483;2494
Syddanmark;28-5-2020;M;1;0;0;590;11484;2494
Hovedstaden;29-5-2020;F;15;1;1;591;11499;2495
Sjælland;29-5-2020;F;3;0;1;591;11502;2496
Syddanmark;29-5-2020;F;1;0;0;591;11503;2496
Hovedstaden;29-5-2020;M;13;2;2;593;11516;2498
Sjælland;29-5-2020;M;8;0;2;593;11524;2500
Syddanmark;29-5-2020;M;2;0;0;593;11526;2500
Hovedstaden;30-5-2020;F;9;0;2;593;11535;2502
Sjælland;30-5-2020;F;7;0;1;593;11542;2503
Hovedstaden;30-5-2020;M;14;1;2;594;11556;2505
Sjælland;30-5-2020;M;2;0;0;594;11558;2505
Syddanmark;30-5-2020;M;1;0;1;594;11559;2506
Hovedstaden;31-5-2020;F;10;0;1;594;11569;2507
Sjælland;31-5-2020;F;5;0;0;594;11574;2507
Hovedstaden;31-5-2020;M;6;0;0;594;11580;2507
Sjælland;31-5-2020;M;1;0;0;594;11581;2507
Hovedstaden;1-6-2020;F;16;0;1;594;11597;2508
Sjælland;1-6-2020;F;2;0;0;594;11599;2508
Hovedstaden;1-6-2020;M;6;0;1;594;11605;2509
Midtjylland;1-6-2020;M;3;0;1;594;11608;2510
Sjælland;1-6-2020;M;6;0;2;594;11614;2512
Syddanmark;1-6-2020;M;2;0;1;594;11616;2513
Hovedstaden;2-6-2020;F;23;0;0;594;11639;2513
Midtjylland;2-6-2020;F;2;0;0;594;11641;2513
Sjælland;2-6-2020;F;12;0;1;594;11653;2514
Syddanmark;2-6-2020;F;3;0;0;594;11656;2514
Hovedstaden;2-6-2020;M;9;0;0;594;11665;2514
Midtjylland;2-6-2020;M;1;0;0;594;11666;2514
Sjælland;2-6-2020;M;4;0;1;594;11670;2515
Syddanmark;2-6-2020;M;1;0;0;594;11671;2515
Hovedstaden;3-6-2020;F;24;0;1;594;11695;2516
Sjælland;3-6-2020;F;9;0;1;594;11704;2517
Syddanmark;3-6-2020;F;1;0;0;594;11705;2517
Hovedstaden;3-6-2020;M;9;0;0;594;11714;2517
Sjælland;3-6-2020;M;9;0;0;594;11723;2517
Hovedstaden;4-6-2020;F;18;0;1;594;11741;2518
Sjælland;4-6-2020;F;4;0;0;594;11745;2518
Syddanmark;4-6-2020;F;1;0;0;594;11746;2518
Hovedstaden;4-6-2020;M;8;1;1;595;11754;2519
Midtjylland;4-6-2020;M;5;0;0;595;11759;2519
Sjælland;4-6-2020;M;2;0;0;595;11761;2519
Syddanmark;4-6-2020;M;3;1;1;596;11764;2520
Hovedstaden;5-6-2020;F;14;0;2;596;11778;2522
Sjælland;5-6-2020;F;2;0;0;596;11780;2522
Hovedstaden;5-6-2020;M;14;0;1;596;11794;2523
Sjælland;5-6-2020;M;2;0;0;596;11796;2523
Syddanmark;5-6-2020;M;2;0;2;596;11798;2525
Hovedstaden;6-6-2020;F;7;0;1;596;11805;2526
Midtjylland;6-6-2020;F;1;0;0;596;11806;2526
Sjælland;6-6-2020;F;2;0;0;596;11808;2526
Hovedstaden;6-6-2020;M;4;0;0;596;11812;2526
Syddanmark;6-6-2020;M;1;0;0;596;11813;2526
Hovedstaden;7-6-2020;F;4;0;1;596;11817;2527
Hovedstaden;7-6-2020;M;10;0;1;596;11827;2528
Hovedstaden;8-6-2020;F;14;0;1;596;11841;2529
Midtjylland;8-6-2020;F;1;0;0;596;11842;2529
Nordjylland;8-6-2020;F;1;0;0;596;11843;2529
Sjælland;8-6-2020;F;1;0;0;596;11844;2529
Syddanmark;8-6-2020;F;3;0;0;596;11847;2529
Hovedstaden;8-6-2020;M;15;1;2;597;11862;2531
Midtjylland;8-6-2020;M;2;0;0;597;11864;2531
Sjælland;8-6-2020;M;1;0;0;597;11865;2531
Syddanmark;8-6-2020;M;5;0;0;597;11870;2531
Hovedstaden;9-6-2020;F;10;0;0;597;11880;2531
Sjælland;9-6-2020;F;3;0;0;597;11883;2531
Hovedstaden;9-6-2020;M;11;0;0;597;11894;2531
Midtjylland;9-6-2020;M;1;0;0;597;11895;2531
Sjælland;9-6-2020;M;1;0;0;597;11896;2531
Syddanmark;9-6-2020;M;2;0;0;597;11898;2531
Hovedstaden;10-6-2020;F;10;0;1;597;11908;2532
Midtjylland;10-6-2020;F;2;0;1;597;11910;2533
Nordjylland;10-6-2020;F;6;0;1;597;11916;2534
Sjælland;10-6-2020;F;3;0;1;597;11919;2535
Syddanmark;10-6-2020;F;1;0;0;597;11920;2535
Hovedstaden;10-6-2020;M;9;0;0;597;11929;2535
Nordjylland;10-6-2020;M;3;1;0;598;11932;2535
Sjælland;10-6-2020;M;4;0;0;598;11936;2535
Hovedstaden;11-6-2020;F;19;0;0;598;11955;2535
Midtjylland;11-6-2020;F;1;0;0;598;11956;2535
Nordjylland;11-6-2020;F;1;0;0;598;11957;2535
Sjælland;11-6-2020;F;6;0;0;598;11963;2535
Hovedstaden;11-6-2020;M;17;0;2;598;11980;2537
Nordjylland;11-6-2020;M;1;0;1;598;11981;2538
Sjælland;11-6-2020;M;3;0;0;598;11984;2538
Hovedstaden;12-6-2020;F;13;0;1;598;11997;2539
Midtjylland;12-6-2020;F;2;0;0;598;11999;2539
Nordjylland;12-6-2020;F;19;1;4;599;12018;2543
Sjælland;12-6-2020;F;2;1;1;600;12020;2544
Hovedstaden;12-6-2020;M;13;0;2;600;12033;2546
Midtjylland;12-6-2020;M;2;0;0;600;12035;2546
Nordjylland;12-6-2020;M;6;0;1;600;12041;2547
Sjælland;12-6-2020;M;2;0;1;600;12043;2548
Syddanmark;12-6-2020;M;1;0;0;600;12044;2548
Hovedstaden;13-6-2020;F;7;0;1;600;12051;2549
Midtjylland;13-6-2020;F;2;0;0;600;12053;2549
Sjælland;13-6-2020;F;3;0;1;600;12056;2550
Hovedstaden;13-6-2020;M;12;1;3;601;12068;2553
Sjælland;13-6-2020;M;3;0;1;601;12071;2554
Hovedstaden;14-6-2020;F;3;0;0;601;12074;2554
Midtjylland;14-6-2020;F;1;0;0;601;12075;2554
Nordjylland;14-6-2020;F;5;0;1;601;12080;2555
Hovedstaden;14-6-2020;M;6;0;1;601;12086;2556
Nordjylland;14-6-2020;M;3;1;1;602;12089;2557
Sjælland;14-6-2020;M;2;0;0;602;12091;2557
Hovedstaden;15-6-2020;F;15;1;3;603;12106;2560
Nordjylland;15-6-2020;F;2;0;0;603;12108;2560
Sjælland;15-6-2020;F;1;0;0;603;12109;2560
Hovedstaden;15-6-2020;M;16;1;2;604;12125;2562
Midtjylland;15-6-2020;M;1;0;1;604;12126;2563
Nordjylland;15-6-2020;M;1;0;0;604;12127;2563
Sjælland;15-6-2020;M;3;0;0;604;12130;2563
Hovedstaden;16-6-2020;F;15;0;0;604;12145;2563
Midtjylland;16-6-2020;F;4;0;1;604;12149;2564
Nordjylland;16-6-2020;F;3;0;1;604;12152;2565
Sjælland;16-6-2020;F;4;0;1;604;12156;2566
Hovedstaden;16-6-2020;M;10;0;2;604;12166;2568
Midtjylland;16-6-2020;M;1;0;0;604;12167;2568
Nordjylland;16-6-2020;M;4;0;0;604;12171;2568
Sjælland;16-6-2020;M;3;0;1;604;12174;2569
Syddanmark;16-6-2020;M;1;0;0;604;12175;2569
Hovedstaden;17-6-2020;F;21;0;1;604;12196;2570
Midtjylland;17-6-2020;F;1;0;0;604;12197;2570
Nordjylland;17-6-2020;F;14;0;2;604;12211;2572
Sjælland;17-6-2020;F;7;0;0;604;12218;2572
Syddanmark;17-6-2020;F;1;0;0;604;12219;2572
Hovedstaden;17-6-2020;M;20;0;1;604;12239;2573
Midtjylland;17-6-2020;M;2;0;0;604;12241;2573
Nordjylland;17-6-2020;M;2;0;1;604;12243;2574
Sjælland;17-6-2020;M;5;0;1;604;12248;2575
Syddanmark;17-6-2020;M;1;0;1;604;12249;2576
Hovedstaden;18-6-2020;F;17;0;0;604;12266;2576
Midtjylland;18-6-2020;F;1;0;0;604;12267;2576
Nordjylland;18-6-2020;F;1;0;0;604;12268;2576
Sjælland;18-6-2020;F;4;0;2;604;12272;2578
Hovedstaden;18-6-2020;M;18;0;0;604;12290;2578
Nordjylland;18-6-2020;M;1;0;0;604;12291;2578
Sjælland;18-6-2020;M;2;0;0;604;12293;2578
Syddanmark;18-6-2020;M;1;0;0;604;12294;2578
Hovedstaden;19-6-2020;F;15;0;2;604;12309;2580
Sjælland;19-6-2020;F;7;0;1;604;12316;2581
Hovedstaden;19-6-2020;M;9;0;0;604;12325;2581
Midtjylland;19-6-2020;M;2;0;0;604;12327;2581
Nordjylland;19-6-2020;M;1;0;0;604;12328;2581
Sjælland;19-6-2020;M;8;0;0;604;12336;2581
Hovedstaden;20-6-2020;F;18;0;0;604;12354;2581
Nordjylland;20-6-2020;F;2;0;0;604;12356;2581
Sjælland;20-6-2020;F;3;0;0;604;12359;2581
Hovedstaden;20-6-2020;M;12;0;0;604;12371;2581
Midtjylland;20-6-2020;M;2;0;0;604;12373;2581
Sjælland;20-6-2020;M;1;0;0;604;12374;2581
Hovedstaden;21-6-2020;F;16;0;0;604;12390;2581
Nordjylland;21-6-2020;F;1;0;1;604;12391;2582
Syddanmark;21-6-2020;F;1;0;0;604;12392;2582
Hovedstaden;21-6-2020;M;9;0;1;604;12401;2583
Midtjylland;21-6-2020;M;1;0;0;604;12402;2583
Nordjylland;21-6-2020;M;2;0;2;604;12404;2585
Sjælland;21-6-2020;M;1;0;0;604;12405;2585
Hovedstaden;22-6-2020;F;22;0;1;604;12427;2586
Nordjylland;22-6-2020;F;2;0;1;604;12429;2587
Sjælland;22-6-2020;F;1;0;0;604;12430;2587
Hovedstaden;22-6-2020;M;17;0;1;604;12447;2588
Midtjylland;22-6-2020;M;1;0;0;604;12448;2588
Nordjylland;22-6-2020;M;1;0;0;604;12449;2588
Sjælland;22-6-2020;M;1;0;1;604;12450;2589
Hovedstaden;23-6-2020;F;4;0;1;604;12454;2590
Midtjylland;23-6-2020;F;3;0;0;604;12457;2590
Nordjylland;23-6-2020;F;1;0;0;604;12458;2590
Syddanmark;23-6-2020;F;2;0;0;604;12460;2590
Hovedstaden;23-6-2020;M;4;0;0;604;12464;2590
Midtjylland;23-6-2020;M;1;0;0;604;12465;2590
Nordjylland;23-6-2020;M;3;0;1;604;12468;2591
Sjælland;23-6-2020;M;1;0;0;604;12469;2591
Hovedstaden;24-6-2020;F;9;0;2;604;12478;2593
Midtjylland;24-6-2020;F;2;0;0;604;12480;2593
Nordjylland;24-6-2020;F;7;0;1;604;12487;2594
Sjælland;24-6-2020;F;2;0;1;604;12489;2595
Syddanmark;24-6-2020;F;1;0;0;604;12490;2595
Hovedstaden;24-6-2020;M;6;0;1;604;12496;2596
Midtjylland;24-6-2020;M;1;0;0;604;12497;2596
Nordjylland;24-6-2020;M;10;0;4;604;12507;2600
Sjælland;24-6-2020;M;3;0;0;604;12510;2600
Syddanmark;24-6-2020;M;4;0;1;604;12514;2601
Hovedstaden;25-6-2020;F;12;0;0;604;12526;2601
Midtjylland;25-6-2020;F;3;0;0;604;12529;2601
Nordjylland;25-6-2020;F;2;0;0;604;12531;2601
Hovedstaden;25-6-2020;M;6;0;0;604;12537;2601
Midtjylland;25-6-2020;M;2;0;1;604;12539;2602
Nordjylland;25-6-2020;M;3;0;0;604;12542;2602
Sjælland;25-6-2020;M;1;0;1;604;12543;2603
Syddanmark;25-6-2020;M;1;0;0;604;12544;2603
Hovedstaden;26-6-2020;F;5;0;0;604;12549;2603
Midtjylland;26-6-2020;F;1;0;0;604;12550;2603
Nordjylland;26-6-2020;F;1;0;0;604;12551;2603
Syddanmark;26-6-2020;F;1;0;0;604;12552;2603
Hovedstaden;26-6-2020;M;7;0;2;604;12559;2605
Midtjylland;26-6-2020;M;2;0;0;604;12561;2605
Nordjylland;26-6-2020;M;1;0;0;604;12562;2605
Sjælland;26-6-2020;M;2;0;0;604;12564;2605
Hovedstaden;27-6-2020;F;1;0;0;604;12565;2605
Midtjylland;27-6-2020;F;1;0;1;604;12566;2606
Nordjylland;27-6-2020;F;4;0;1;604;12570;2607
Hovedstaden;27-6-2020;M;5;0;0;604;12575;2607
Midtjylland;27-6-2020;M;2;0;0;604;12577;2607
Nordjylland;27-6-2020;M;5;0;2;604;12582;2609
Hovedstaden;28-6-2020;F;3;0;0;604;12585;2609
Midtjylland;28-6-2020;F;2;0;0;604;12587;2609
Nordjylland;28-6-2020;F;1;0;0;604;12588;2609
Hovedstaden;28-6-2020;M;2;0;1;604;12590;2610
Midtjylland;28-6-2020;M;2;0;0;604;12592;2610
Syddanmark;28-6-2020;M;1;0;0;604;12593;2610
Hovedstaden;29-6-2020;F;11;0;0;604;12604;2610
Midtjylland;29-6-2020;F;1;0;0;604;12605;2610
Nordjylland;29-6-2020;F;1;0;0;604;12606;2610
Syddanmark;29-6-2020;F;2;0;0;604;12608;2610
Hovedstaden;29-6-2020;M;9;0;0;604;12617;2610
Nordjylland;29-6-2020;M;1;0;0;604;12618;2610
Sjælland;29-6-2020;M;2;0;0;604;12620;2610
Hovedstaden;30-6-2020;F;4;0;0;604;12624;2610
Midtjylland;30-6-2020;F;1;0;0;604;12625;2610
Nordjylland;30-6-2020;F;5;0;1;604;12630;2611
Sjælland;30-6-2020;F;2;0;0;604;12632;2611
Syddanmark;30-6-2020;F;1;0;0;604;12633;2611
Hovedstaden;30-6-2020;M;6;0;2;604;12639;2613
Midtjylland;30-6-2020;M;1;0;0;604;12640;2613
Nordjylland;30-6-2020;M;1;0;1;604;12641;2614
Sjælland;30-6-2020;M;2;0;0;604;12643;2614
Hovedstaden;1-7-2020;F;2;0;0;604;12645;2614
Nordjylland;1-7-2020;F;1;0;0;604;12646;2614
Hovedstaden;1-7-2020;M;4;0;1;604;12650;2615
Midtjylland;1-7-2020;M;2;0;0;604;12652;2615
Nordjylland;1-7-2020;M;1;0;0;604;12653;2615
Hovedstaden;2-7-2020;F;8;0;0;604;12661;2615
Midtjylland;2-7-2020;F;1;0;0;604;12662;2615
Hovedstaden;2-7-2020;M;6;1;1;605;12668;2616
Hovedstaden;3-7-2020;F;5;1;0;606;12673;2616
Nordjylland;3-7-2020;F;3;0;0;606;12676;2616
Hovedstaden;3-7-2020;M;6;0;0;606;12682;2616
Midtjylland;3-7-2020;M;1;0;0;606;12683;2616
Nordjylland;3-7-2020;M;2;0;0;606;12685;2616
Hovedstaden;4-7-2020;F;2;0;0;606;12687;2616
Hovedstaden;4-7-2020;M;8;0;0;606;12695;2616
Nordjylland;4-7-2020;M;1;0;0;606;12696;2616
Syddanmark;4-7-2020;M;2;0;0;606;12698;2616
Hovedstaden;5-7-2020;F;6;0;0;606;12704;2616
Hovedstaden;5-7-2020;M;2;0;0;606;12706;2616
Midtjylland;5-7-2020;M;1;0;0;606;12707;2616
Nordjylland;5-7-2020;M;1;0;0;606;12708;2616
Syddanmark;5-7-2020;M;1;0;1;606;12709;2617
Hovedstaden;6-7-2020;F;2;0;1;606;12711;2618
Nordjylland;6-7-2020;F;1;0;0;606;12712;2618
Hovedstaden;6-7-2020;M;3;0;0;606;12715;2618
Nordjylland;6-7-2020;M;1;0;0;606;12716;2618
Sjælland;6-7-2020;M;1;0;1;606;12717;2619
Syddanmark;6-7-2020;M;1;0;0;606;12718;2619
Hovedstaden;7-7-2020;F;1;0;0;606;12719;2619
Midtjylland;7-7-2020;F;1;0;0;606;12720;2619
Nordjylland;7-7-2020;F;1;0;0;606;12721;2619
Syddanmark;7-7-2020;F;1;0;0;606;12722;2619
Hovedstaden;7-7-2020;M;8;0;2;606;12730;2621
Nordjylland;7-7-2020;M;1;0;0;606;12731;2621
Hovedstaden;8-7-2020;F;10;0;1;606;12741;2622
Nordjylland;8-7-2020;F;3;0;1;606;12744;2623
Sjælland;8-7-2020;F;2;0;0;606;12746;2623
Hovedstaden;8-7-2020;M;9;0;0;606;12755;2623
Midtjylland;8-7-2020;M;1;0;0;606;12756;2623
Syddanmark;8-7-2020;M;1;0;1;606;12757;2624
Hovedstaden;9-7-2020;F;12;0;2;606;12769;2626
Midtjylland;9-7-2020;F;3;0;1;606;12772;2627
Nordjylland;9-7-2020;F;4;0;0;606;12776;2627
Sjælland;9-7-2020;F;5;0;1;606;12781;2628
Hovedstaden;9-7-2020;M;10;0;1;606;12791;2629
Midtjylland;9-7-2020;M;1;0;0;606;12792;2629
Nordjylland;9-7-2020;M;2;0;0;606;12794;2629
Sjælland;9-7-2020;M;4;0;0;606;12798;2629
Hovedstaden;10-7-2020;F;11;0;0;606;12809;2629
Nordjylland;10-7-2020;F;1;0;0;606;12810;2629
Sjælland;10-7-2020;F;1;0;0;606;12811;2629
Syddanmark;10-7-2020;F;1;0;0;606;12812;2629
Hovedstaden;10-7-2020;M;12;0;0;606;12824;2629
Nordjylland;10-7-2020;M;2;1;1;607;12826;2630
Sjælland;10-7-2020;M;3;0;0;607;12829;2630
Syddanmark;10-7-2020;M;2;0;0;607;12831;2630
Hovedstaden;11-7-2020;F;12;1;1;608;12843;2631
Sjælland;11-7-2020;F;1;0;0;608;12844;2631
Syddanmark;11-7-2020;F;2;0;0;608;12846;2631
Hovedstaden;11-7-2020;M;8;0;1;608;12854;2632
Sjælland;11-7-2020;M;1;0;0;608;12855;2632
Hovedstaden;12-7-2020;F;9;0;1;608;12864;2633
Nordjylland;12-7-2020;F;1;0;0;608;12865;2633
Sjælland;12-7-2020;F;1;0;0;608;12866;2633
Hovedstaden;12-7-2020;M;5;0;1;608;12871;2634
Midtjylland;12-7-2020;M;1;0;0;608;12872;2634
Nordjylland;12-7-2020;M;1;0;0;608;12873;2634
Sjælland;12-7-2020;M;4;0;0;608;12877;2634
Hovedstaden;13-7-2020;F;10;0;0;608;12887;2634
Midtjylland;13-7-2020;F;3;0;0;608;12890;2634
Sjælland;13-7-2020;F;7;0;3;608;12897;2637
Syddanmark;13-7-2020;F;1;0;0;608;12898;2637
Hovedstaden;13-7-2020;M;5;0;0;608;12903;2637
Midtjylland;13-7-2020;M;3;0;0;608;12906;2637
Sjælland;13-7-2020;M;2;0;0;608;12908;2637
Syddanmark;13-7-2020;M;1;0;0;608;12909;2637
Hovedstaden;14-7-2020;F;13;0;0;608;12922;2637
Midtjylland;14-7-2020;F;2;0;0;608;12924;2637
Sjælland;14-7-2020;F;2;0;0;608;12926;2637
Syddanmark;14-7-2020;F;2;0;0;608;12928;2637
Hovedstaden;14-7-2020;M;6;0;0;608;12934;2637
Midtjylland;14-7-2020;M;2;0;0;608;12936;2637
Nordjylland;14-7-2020;M;1;0;0;608;12937;2637
Sjælland;14-7-2020;M;3;0;0;608;12940;2637
Syddanmark;14-7-2020;M;2;0;0;608;12942;2637
Hovedstaden;15-7-2020;F;17;0;0;608;12959;2637
Midtjylland;15-7-2020;F;1;0;0;608;12960;2637
Nordjylland;15-7-2020;F;1;0;0;608;12961;2637
Sjælland;15-7-2020;F;2;0;0;608;12963;2637
Syddanmark;15-7-2020;F;1;0;0;608;12964;2637
Hovedstaden;15-7-2020;M;14;0;4;608;12978;2641
Midtjylland;15-7-2020;M;2;0;1;608;12980;2642
Nordjylland;15-7-2020;M;1;0;0;608;12981;2642
Sjælland;15-7-2020;M;2;0;1;608;12983;2643
Syddanmark;15-7-2020;M;1;0;0;608;12984;2643
Hovedstaden;16-7-2020;F;16;1;1;609;13000;2644
Midtjylland;16-7-2020;F;3;0;0;609;13003;2644
Sjælland;16-7-2020;F;3;0;0;609;13006;2644
Syddanmark;16-7-2020;F;4;0;0;609;13010;2644
Hovedstaden;16-7-2020;M;17;0;2;609;13027;2646
Midtjylland;16-7-2020;M;2;0;0;609;13029;2646
Sjælland;16-7-2020;M;6;0;0;609;13035;2646
Syddanmark;16-7-2020;M;1;0;0;609;13036;2646
Hovedstaden;17-7-2020;F;8;0;0;609;13044;2646
Midtjylland;17-7-2020;F;1;0;0;609;13045;2646
Nordjylland;17-7-2020;F;1;0;0;609;13046;2646
Sjælland;17-7-2020;F;5;0;0;609;13051;2646
Hovedstaden;17-7-2020;M;11;0;1;609;13062;2647
Nordjylland;17-7-2020;M;1;0;0;609;13063;2647
Sjælland;17-7-2020;M;5;0;0;609;13068;2647
Hovedstaden;18-7-2020;F;17;0;3;609;13085;2650
Sjælland;18-7-2020;F;7;0;0;609;13092;2650
Hovedstaden;18-7-2020;M;13;0;0;609;13105;2650
Sjælland;18-7-2020;M;6;0;1;609;13111;2651
Hovedstaden;19-7-2020;F;15;0;2;609;13126;2653
Nordjylland;19-7-2020;F;1;0;0;609;13127;2653
Sjælland;19-7-2020;F;3;0;0;609;13130;2653
Hovedstaden;19-7-2020;M;3;0;0;609;13133;2653
Midtjylland;19-7-2020;M;1;0;0;609;13134;2653
Nordjylland;19-7-2020;M;1;0;0;609;13135;2653
Sjælland;19-7-2020;M;4;0;1;609;13139;2654
Hovedstaden;20-7-2020;F;11;0;0;609;13150;2654
Midtjylland;20-7-2020;F;1;0;0;609;13151;2654
Sjælland;20-7-2020;F;4;0;0;609;13155;2654
Syddanmark;20-7-2020;F;1;0;0;609;13156;2654
Hovedstaden;20-7-2020;M;10;0;0;609;13166;2654
Midtjylland;20-7-2020;M;2;0;0;609;13168;2654
Sjælland;20-7-2020;M;3;0;0;609;13171;2654
Hovedstaden;21-7-2020;F;17;0;1;609;13188;2655
Nordjylland;21-7-2020;F;2;0;0;609;13190;2655
Sjælland;21-7-2020;F;3;0;0;609;13193;2655
Hovedstaden;21-7-2020;M;10;0;3;609;13203;2658
Midtjylland;21-7-2020;M;2;0;0;609;13205;2658
Nordjylland;21-7-2020;M;1;0;0;609;13206;2658
Sjælland;21-7-2020;M;1;0;0;609;13207;2658
Hovedstaden;22-7-2020;F;15;0;0;609;13222;2658
Nordjylland;22-7-2020;F;1;0;0;609;13223;2658
Sjælland;22-7-2020;F;1;0;0;609;13224;2658
Syddanmark;22-7-2020;F;1;0;0;609;13225;2658
Hovedstaden;22-7-2020;M;7;1;1;610;13232;2659
Nordjylland;22-7-2020;M;3;0;0;610;13235;2659
Sjælland;22-7-2020;M;5;0;0;610;13240;2659
Syddanmark;22-7-2020;M;1;0;1;610;13241;2660
Hovedstaden;23-7-2020;F;25;1;0;611;13266;2660
Midtjylland;23-7-2020;F;2;0;0;611;13268;2660
Nordjylland;23-7-2020;F;1;0;0;611;13269;2660
Sjælland;23-7-2020;F;2;0;0;611;13271;2660
Syddanmark;23-7-2020;F;4;0;0;611;13275;2660
Hovedstaden;23-7-2020;M;11;0;0;611;13286;2660
Nordjylland;23-7-2020;M;2;0;1;611;13288;2661
Sjælland;23-7-2020;M;3;0;1;611;13291;2662
Syddanmark;23-7-2020;M;1;0;0;611;13292;2662
Hovedstaden;24-7-2020;F;9;1;1;612;13301;2663
Midtjylland;24-7-2020;F;5;0;0;612;13306;2663
Sjælland;24-7-2020;F;1;0;0;612;13307;2663
Syddanmark;24-7-2020;F;2;0;1;612;13309;2664
Hovedstaden;24-7-2020;M;12;0;0;612;13321;2664
Midtjylland;24-7-2020;M;3;0;0;612;13324;2664
Nordjylland;24-7-2020;M;1;0;0;612;13325;2664
Sjælland;24-7-2020;M;1;0;0;612;13326;2664
Syddanmark;24-7-2020;M;2;0;1;612;13328;2665
Hovedstaden;25-7-2020;F;6;0;0;612;13334;2665
Midtjylland;25-7-2020;F;3;0;0;612;13337;2665
Sjælland;25-7-2020;F;5;0;0;612;13342;2665
Syddanmark;25-7-2020;F;2;0;0;612;13344;2665
Hovedstaden;25-7-2020;M;3;0;0;612;13347;2665
Midtjylland;25-7-2020;M;2;0;0;612;13349;2665
Nordjylland;25-7-2020;M;1;0;1;612;13350;2666
Sjælland;25-7-2020;M;4;1;2;613;13354;2668
Syddanmark;25-7-2020;M;1;0;0;613;13355;2668
Hovedstaden;26-7-2020;F;8;0;1;613;13363;2669
Midtjylland;26-7-2020;F;4;0;0;613;13367;2669
Nordjylland;26-7-2020;F;1;0;0;613;13368;2669
Sjælland;26-7-2020;F;2;0;1;613;13370;2670
Syddanmark;26-7-2020;F;3;0;0;613;13373;2670
Hovedstaden;26-7-2020;M;4;0;0;613;13377;2670
Syddanmark;26-7-2020;M;1;0;0;613;13378;2670
Hovedstaden;27-7-2020;F;9;0;1;613;13387;2671
Midtjylland;27-7-2020;F;3;0;0;613;13390;2671
Nordjylland;27-7-2020;F;1;0;0;613;13391;2671
Sjælland;27-7-2020;F;6;0;3;613;13397;2674
Syddanmark;27-7-2020;F;5;0;0;613;13402;2674
Hovedstaden;27-7-2020;M;14;0;0;613;13416;2674
Midtjylland;27-7-2020;M;3;0;0;613;13419;2674
Nordjylland;27-7-2020;M;1;0;0;613;13420;2674
Sjælland;27-7-2020;M;16;0;2;613;13436;2676
Syddanmark;27-7-2020;M;5;0;0;613;13441;2676
Hovedstaden;28-7-2020;F;6;0;0;613;13447;2676
Midtjylland;28-7-2020;F;8;0;1;613;13455;2677
Nordjylland;28-7-2020;F;2;0;0;613;13457;2677
Sjælland;28-7-2020;F;3;0;0;613;13460;2677
Syddanmark;28-7-2020;F;4;0;0;613;13464;2677
Hovedstaden;28-7-2020;M;24;0;0;613;13488;2677
Midtjylland;28-7-2020;M;4;0;0;613;13492;2677
Nordjylland;28-7-2020;M;2;0;0;613;13494;2677
Sjælland;28-7-2020;M;23;0;4;613;13517;2681
Syddanmark;28-7-2020;M;1;0;1;613;13518;2682
Hovedstaden;29-7-2020;F;8;0;1;613;13526;2683
Midtjylland;29-7-2020;F;4;0;1;613;13530;2684
Nordjylland;29-7-2020;F;1;0;1;613;13531;2685
Sjælland;29-7-2020;F;3;1;1;614;13534;2686
Syddanmark;29-7-2020;F;2;0;0;614;13536;2686
Hovedstaden;29-7-2020;M;14;0;1;614;13550;2687
Midtjylland;29-7-2020;M;6;0;2;614;13556;2689
Nordjylland;29-7-2020;M;4;0;0;614;13560;2689
Sjælland;29-7-2020;M;10;0;1;614;13570;2690
Syddanmark;29-7-2020;M;7;0;0;614;13577;2690
Hovedstaden;30-7-2020;F;12;0;0;614;13589;2690
Midtjylland;30-7-2020;F;14;0;0;614;13603;2690
Nordjylland;30-7-2020;F;2;0;0;614;13605;2690
Sjælland;30-7-2020;F;7;0;0;614;13612;2690
Syddanmark;30-7-2020;F;2;0;0;614;13614;2690
Hovedstaden;30-7-2020;M;14;0;1;614;13628;2691
Midtjylland;30-7-2020;M;7;0;1;614;13635;2692
Nordjylland;30-7-2020;M;2;0;0;614;13637;2692
Sjælland;30-7-2020;M;19;0;0;614;13656;2692
Syddanmark;30-7-2020;M;5;0;0;614;13661;2692
Hovedstaden;31-7-2020;F;9;0;0;614;13670;2692
Midtjylland;31-7-2020;F;5;0;0;614;13675;2692
Nordjylland;31-7-2020;F;2;0;0;614;13677;2692
Sjælland;31-7-2020;F;4;0;0;614;13681;2692
Syddanmark;31-7-2020;F;4;0;0;614;13685;2692
Hovedstaden;31-7-2020;M;4;0;0;614;13689;2692
Midtjylland;31-7-2020;M;13;0;2;614;13702;2694
Nordjylland;31-7-2020;M;1;0;0;614;13703;2694
Sjælland;31-7-2020;M;9;0;0;614;13712;2694
Syddanmark;31-7-2020;M;7;0;0;614;13719;2694
Hovedstaden;1-8-2020;F;4;0;0;614;13723;2694
Midtjylland;1-8-2020;F;7;1;1;615;13730;2695
Nordjylland;1-8-2020;F;1;0;0;615;13731;2695
Sjælland;1-8-2020;F;3;0;0;615;13734;2695
Syddanmark;1-8-2020;F;3;0;0;615;13737;2695
Hovedstaden;1-8-2020;M;6;0;0;615;13743;2695
Midtjylland;1-8-2020;M;23;0;0;615;13766;2695
Nordjylland;1-8-2020;M;3;0;0;615;13769;2695
Sjælland;1-8-2020;M;11;0;0;615;13780;2695
Syddanmark;1-8-2020;M;3;0;0;615;13783;2695
Hovedstaden;2-8-2020;F;12;0;0;615;13795;2695
Midtjylland;2-8-2020;F;14;0;0;615;13809;2695
Nordjylland;2-8-2020;F;2;0;0;615;13811;2695
Sjælland;2-8-2020;F;3;0;0;615;13814;2695
Syddanmark;2-8-2020;F;1;0;0;615;13815;2695
Hovedstaden;2-8-2020;M;9;0;0;615;13824;2695
Midtjylland;2-8-2020;M;25;0;2;615;13849;2697
Nordjylland;2-8-2020;M;4;0;0;615;13853;2697
Sjælland;2-8-2020;M;6;1;1;616;13859;2698
Syddanmark;2-8-2020;M;2;0;0;616;13861;2698
Hovedstaden;3-8-2020;F;9;0;0;616;13870;2698
Midtjylland;3-8-2020;F;24;0;1;616;13894;2699
Nordjylland;3-8-2020;F;3;0;0;616;13897;2699
Sjælland;3-8-2020;F;8;0;0;616;13905;2699
Syddanmark;3-8-2020;F;4;0;0;616;13909;2699
Hovedstaden;3-8-2020;M;12;0;0;616;13921;2699
Midtjylland;3-8-2020;M;29;0;2;616;13950;2701
Nordjylland;3-8-2020;M;2;0;0;616;13952;2701
Sjælland;3-8-2020;M;21;0;2;616;13973;2703
Syddanmark;3-8-2020;M;5;0;0;616;13978;2703
Hovedstaden;4-8-2020;F;14;0;0;616;13992;2703
Midtjylland;4-8-2020;F;21;0;0;616;14013;2703
Nordjylland;4-8-2020;F;3;0;0;616;14016;2703
Sjælland;4-8-2020;F;9;0;0;616;14025;2703
Syddanmark;4-8-2020;F;4;0;0;616;14029;2703
Hovedstaden;4-8-2020;M;11;0;1;616;14040;2704
Midtjylland;4-8-2020;M;38;0;1;616;14078;2705
Nordjylland;4-8-2020;M;1;0;0;616;14079;2705
Sjælland;4-8-2020;M;12;0;3;616;14091;2708
Syddanmark;4-8-2020;M;8;0;0;616;14099;2708
Hovedstaden;5-8-2020;F;14;0;0;616;14113;2708
Midtjylland;5-8-2020;F;25;0;2;616;14138;2710
Nordjylland;5-8-2020;F;2;0;0;616;14140;2710
Sjælland;5-8-2020;F;3;0;0;616;14143;2710
Syddanmark;5-8-2020;F;3;0;0;616;14146;2710
Hovedstaden;5-8-2020;M;15;0;1;616;14161;2711
Midtjylland;5-8-2020;M;41;0;2;616;14202;2713
Nordjylland;5-8-2020;M;2;0;0;616;14204;2713
Sjælland;5-8-2020;M;5;0;1;616;14209;2714
Syddanmark;5-8-2020;M;6;0;0;616;14215;2714
Hovedstaden;6-8-2020;F;13;0;2;616;14228;2716
Midtjylland;6-8-2020;F;37;0;1;616;14265;2717
Nordjylland;6-8-2020;F;3;0;0;616;14268;2717
Sjælland;6-8-2020;F;5;0;0;616;14273;2717
Syddanmark;6-8-2020;F;7;0;1;616;14280;2718
Hovedstaden;6-8-2020;M;22;0;2;616;14302;2720
Midtjylland;6-8-2020;M;49;0;1;616;14351;2721
Nordjylland;6-8-2020;M;1;0;0;616;14352;2721
Sjælland;6-8-2020;M;27;0;0;616;14379;2721
Syddanmark;6-8-2020;M;7;0;0;616;14386;2721
Hovedstaden;7-8-2020;F;13;0;1;616;14399;2722
Midtjylland;7-8-2020;F;46;0;2;616;14445;2724
Nordjylland;7-8-2020;F;2;0;0;616;14447;2724
Sjælland;7-8-2020;F;4;0;0;616;14451;2724
Syddanmark;7-8-2020;F;2;0;0;616;14453;2724
Hovedstaden;7-8-2020;M;7;0;0;616;14460;2724
Midtjylland;7-8-2020;M;60;0;0;616;14520;2724
Nordjylland;7-8-2020;M;2;0;0;616;14522;2724
Sjælland;7-8-2020;M;3;0;0;616;14525;2724
Syddanmark;7-8-2020;M;2;0;0;616;14527;2724
Hovedstaden;8-8-2020;F;11;0;0;616;14538;2724
Midtjylland;8-8-2020;F;26;1;2;617;14564;2726
Nordjylland;8-8-2020;F;1;0;0;617;14565;2726
Sjælland;8-8-2020;F;5;0;0;617;14570;2726
Syddanmark;8-8-2020;F;1;0;0;617;14571;2726
Hovedstaden;8-8-2020;M;8;0;0;617;14579;2726
Midtjylland;8-8-2020;M;31;0;1;617;14610;2727
Nordjylland;8-8-2020;M;1;0;0;617;14611;2727
Sjælland;8-8-2020;M;3;0;1;617;14614;2728
Syddanmark;8-8-2020;M;2;0;0;617;14616;2728
Hovedstaden;9-8-2020;F;14;0;0;617;14630;2728
Midtjylland;9-8-2020;F;32;0;0;617;14662;2728
Nordjylland;9-8-2020;F;5;0;0;617;14667;2728
Sjælland;9-8-2020;F;2;0;0;617;14669;2728
Syddanmark;9-8-2020;F;6;0;0;617;14675;2728
Hovedstaden;9-8-2020;M;27;0;0;617;14702;2728
Midtjylland;9-8-2020;M;33;0;1;617;14735;2729
Nordjylland;9-8-2020;M;4;0;0;617;14739;2729
Sjælland;9-8-2020;M;2;0;0;617;14741;2729
Syddanmark;9-8-2020;M;4;0;0;617;14745;2729
Hovedstaden;10-8-2020;F;17;0;0;617;14762;2729
Midtjylland;10-8-2020;F;37;0;0;617;14799;2729
Nordjylland;10-8-2020;F;2;0;0;617;14801;2729
Sjælland;10-8-2020;F;6;0;1;617;14807;2730
Syddanmark;10-8-2020;F;3;0;0;617;14810;2730
Hovedstaden;10-8-2020;M;26;0;1;617;14836;2731
Midtjylland;10-8-2020;M;43;0;1;617;14879;2732
Nordjylland;10-8-2020;M;5;0;0;617;14884;2732
Sjælland;10-8-2020;M;4;0;0;617;14888;2732
Syddanmark;10-8-2020;M;9;0;0;617;14897;2732
Hovedstaden;11-8-2020;F;19;0;1;617;14916;2733
Midtjylland;11-8-2020;F;26;0;1;617;14942;2734
Nordjylland;11-8-2020;F;2;0;0;617;14944;2734
Sjælland;11-8-2020;F;7;0;0;617;14951;2734
Syddanmark;11-8-2020;F;5;0;0;617;14956;2734
Hovedstaden;11-8-2020;M;21;0;1;617;14977;2735
Midtjylland;11-8-2020;M;41;0;1;617;15018;2736
Sjælland;11-8-2020;M;11;0;2;617;15029;2738
Syddanmark;11-8-2020;M;4;0;0;617;15033;2738
Hovedstaden;12-8-2020;F;22;0;4;617;15055;2742
Midtjylland;12-8-2020;F;33;0;2;617;15088;2744
Nordjylland;12-8-2020;F;9;0;0;617;15097;2744
Sjælland;12-8-2020;F;1;0;0;617;15098;2744
Syddanmark;12-8-2020;F;3;0;0;617;15101;2744
Hovedstaden;12-8-2020;M;26;0;0;617;15127;2744
Midtjylland;12-8-2020;M;48;0;0;617;15175;2744
Nordjylland;12-8-2020;M;10;0;2;617;15185;2746
Sjælland;12-8-2020;M;4;0;1;617;15189;2747
Syddanmark;12-8-2020;M;4;0;0;617;15193;2747
Hovedstaden;13-8-2020;F;14;0;0;617;15207;2747
Midtjylland;13-8-2020;F;30;0;0;617;15237;2747
Nordjylland;13-8-2020;F;3;0;1;617;15240;2748
Sjælland;13-8-2020;F;1;0;0;617;15241;2748
Syddanmark;13-8-2020;F;4;0;0;617;15245;2748
Hovedstaden;13-8-2020;M;20;0;0;617;15265;2748
Midtjylland;13-8-2020;M;30;0;0;617;15295;2748
Nordjylland;13-8-2020;M;5;1;1;618;15300;2749
Sjælland;13-8-2020;M;1;0;0;618;15301;2749
Syddanmark;13-8-2020;M;8;0;0;618;15309;2749
Hovedstaden;14-8-2020;F;25;0;0;618;15334;2749
Midtjylland;14-8-2020;F;14;0;0;618;15348;2749
Nordjylland;14-8-2020;F;5;0;0;618;15353;2749
Sjælland;14-8-2020;F;3;0;0;618;15356;2749
Syddanmark;14-8-2020;F;3;0;0;618;15359;2749
Hovedstaden;14-8-2020;M;23;1;2;619;15382;2751
Midtjylland;14-8-2020;M;16;0;1;619;15398;2752
Nordjylland;14-8-2020;M;3;0;0;619;15401;2752
Sjælland;14-8-2020;M;11;0;0;619;15412;2752
Syddanmark;14-8-2020;M;7;0;0;619;15419;2752
Hovedstaden;15-8-2020;F;12;0;0;619;15431;2752
Midtjylland;15-8-2020;F;46;0;3;619;15477;2755
Nordjylland;15-8-2020;F;5;0;0;619;15482;2755
Sjælland;15-8-2020;F;4;0;1;619;15486;2756
Syddanmark;15-8-2020;F;8;0;1;619;15494;2757
Hovedstaden;15-8-2020;M;13;0;0;619;15507;2757
Midtjylland;15-8-2020;M;32;0;0;619;15539;2757
Nordjylland;15-8-2020;M;1;0;0;619;15540;2757
Sjælland;15-8-2020;M;2;0;0;619;15542;2757
Syddanmark;15-8-2020;M;3;0;0;619;15545;2757
Hovedstaden;16-8-2020;F;15;0;0;619;15560;2757
Midtjylland;16-8-2020;F;17;0;1;619;15577;2758
Nordjylland;16-8-2020;F;4;0;0;619;15581;2758
Sjælland;16-8-2020;F;4;0;0;619;15585;2758
Syddanmark;16-8-2020;F;4;0;0;619;15589;2758
Hovedstaden;16-8-2020;M;15;0;1;619;15604;2759
Midtjylland;16-8-2020;M;15;0;0;619;15619;2759
Nordjylland;16-8-2020;M;6;1;1;620;15625;2760
Sjælland;16-8-2020;M;3;0;0;620;15628;2760
Syddanmark;16-8-2020;M;7;0;0;620;15635;2760
Hovedstaden;17-8-2020;F;9;0;1;620;15644;2761
Midtjylland;17-8-2020;F;26;0;0;620;15670;2761
Nordjylland;17-8-2020;F;4;0;0;620;15674;2761
Sjælland;17-8-2020;F;3;0;1;620;15677;2762
Syddanmark;17-8-2020;F;5;0;0;620;15682;2762
Hovedstaden;17-8-2020;M;20;0;0;620;15702;2762
Midtjylland;17-8-2020;M;17;0;1;620;15719;2763
Nordjylland;17-8-2020;M;4;0;0;620;15723;2763
Sjælland;17-8-2020;M;3;0;0;620;15726;2763
Syddanmark;17-8-2020;M;5;0;0;620;15731;2763
Hovedstaden;18-8-2020;F;16;1;2;621;15747;2765
Midtjylland;18-8-2020;F;19;0;0;621;15766;2765
Nordjylland;18-8-2020;F;4;0;0;621;15770;2765
Sjælland;18-8-2020;F;8;0;1;621;15778;2766
Syddanmark;18-8-2020;F;4;0;0;621;15782;2766
Hovedstaden;18-8-2020;M;24;0;0;621;15806;2766
Midtjylland;18-8-2020;M;22;0;0;621;15828;2766
Nordjylland;18-8-2020;M;3;1;1;622;15831;2767
Sjælland;18-8-2020;M;6;0;0;622;15837;2767
Syddanmark;18-8-2020;M;6;0;0;622;15843;2767
Hovedstaden;19-8-2020;F;11;0;1;622;15854;2768
Midtjylland;19-8-2020;F;12;0;0;622;15866;2768
Nordjylland;19-8-2020;F;6;0;0;622;15872;2768
Sjælland;19-8-2020;F;1;0;0;622;15873;2768
Syddanmark;19-8-2020;F;7;1;1;623;15880;2769
Hovedstaden;19-8-2020;M;23;0;1;623;15903;2770
Midtjylland;19-8-2020;M;15;0;1;623;15918;2771
Nordjylland;19-8-2020;M;2;0;0;623;15920;2771
Sjælland;19-8-2020;M;3;0;0;623;15923;2771
Syddanmark;19-8-2020;M;6;0;0;623;15929;2771
Hovedstaden;20-8-2020;F;10;0;1;623;15939;2772
Midtjylland;20-8-2020;F;15;0;1;623;15954;2773
Nordjylland;20-8-2020;F;1;0;0;623;15955;2773
Sjælland;20-8-2020;F;4;0;0;623;15959;2773
Syddanmark;20-8-2020;F;4;0;0;623;15963;2773
Hovedstaden;20-8-2020;M;14;0;0;623;15977;2773
Midtjylland;20-8-2020;M;16;0;1;623;15993;2774
Nordjylland;20-8-2020;M;3;0;0;623;15996;2774
Sjælland;20-8-2020;M;7;0;1;623;16003;2775
Syddanmark;20-8-2020;M;7;0;0;623;16010;2775
Hovedstaden;21-8-2020;F;6;0;0;623;16016;2775
Midtjylland;21-8-2020;F;14;0;1;623;16030;2776
Nordjylland;21-8-2020;F;4;0;1;623;16034;2777
Sjælland;21-8-2020;F;3;0;0;623;16037;2777
Syddanmark;21-8-2020;F;5;0;0;623;16042;2777
Hovedstaden;21-8-2020;M;23;0;0;623;16065;2777
Midtjylland;21-8-2020;M;13;0;0;623;16078;2777
Nordjylland;21-8-2020;M;3;0;0;623;16081;2777
Sjælland;21-8-2020;M;2;0;0;623;16083;2777
Syddanmark;21-8-2020;M;10;0;0;623;16093;2777
Hovedstaden;22-8-2020;F;18;0;0;623;16111;2777
Midtjylland;22-8-2020;F;17;0;0;623;16128;2777
Nordjylland;22-8-2020;F;4;0;0;623;16132;2777
Sjælland;22-8-2020;F;2;0;0;623;16134;2777
Syddanmark;22-8-2020;F;11;0;1;623;16145;2778
Hovedstaden;22-8-2020;M;11;0;0;623;16156;2778
Midtjylland;22-8-2020;M;12;0;0;623;16168;2778
Nordjylland;22-8-2020;M;2;0;1;623;16170;2779
Sjælland;22-8-2020;M;3;0;2;623;16173;2781
Syddanmark;22-8-2020;M;8;0;1;623;16181;2782
Hovedstaden;23-8-2020;F;11;0;0;623;16192;2782
Midtjylland;23-8-2020;F;13;0;0;623;16205;2782
Nordjylland;23-8-2020;F;6;0;0;623;16211;2782
Sjælland;23-8-2020;F;1;0;0;623;16212;2782
Syddanmark;23-8-2020;F;7;0;0;623;16219;2782
Hovedstaden;23-8-2020;M;12;0;1;623;16231;2783
Midtjylland;23-8-2020;M;10;0;0;623;16241;2783
Nordjylland;23-8-2020;M;2;1;1;624;16243;2784
Sjælland;23-8-2020;M;3;0;0;624;16246;2784
Syddanmark;23-8-2020;M;8;0;0;624;16254;2784
Hovedstaden;24-8-2020;F;11;0;1;624;16265;2785
Midtjylland;24-8-2020;F;15;0;0;624;16280;2785
Nordjylland;24-8-2020;F;3;0;0;624;16283;2785
Sjælland;24-8-2020;F;2;0;0;624;16285;2785
Syddanmark;24-8-2020;F;4;0;0;624;16289;2785
Hovedstaden;24-8-2020;M;14;0;2;624;16303;2787
Midtjylland;24-8-2020;M;14;0;2;624;16317;2789
Nordjylland;24-8-2020;M;3;0;0;624;16320;2789
Sjælland;24-8-2020;M;4;0;0;624;16324;2789
Syddanmark;24-8-2020;M;2;0;0;624;16326;2789
Hovedstaden;25-8-2020;F;12;0;1;624;16338;2790
Midtjylland;25-8-2020;F;10;0;0;624;16348;2790
Nordjylland;25-8-2020;F;4;0;0;624;16352;2790
Sjælland;25-8-2020;F;3;0;0;624;16355;2790
Syddanmark;25-8-2020;F;6;0;0;624;16361;2790
Hovedstaden;25-8-2020;M;24;0;0;624;16385;2790
Midtjylland;25-8-2020;M;12;0;1;624;16397;2791
Nordjylland;25-8-2020;M;5;0;0;624;16402;2791
Sjælland;25-8-2020;M;1;0;0;624;16403;2791
Syddanmark;25-8-2020;M;4;0;0;624;16407;2791
Hovedstaden;26-8-2020;F;20;0;1;624;16427;2792
Midtjylland;26-8-2020;F;9;0;0;624;16436;2792
Nordjylland;26-8-2020;F;1;0;0;624;16437;2792
Sjælland;26-8-2020;F;4;0;0;624;16441;2792
Syddanmark;26-8-2020;F;4;0;0;624;16445;2792
Hovedstaden;26-8-2020;M;16;0;0;624;16461;2792
Midtjylland;26-8-2020;M;11;0;0;624;16472;2792
Nordjylland;26-8-2020;M;3;0;1;624;16475;2793
Sjælland;26-8-2020;M;5;0;1;624;16480;2794
Syddanmark;26-8-2020;M;6;0;0;624;16486;2794
Hovedstaden;27-8-2020;F;7;0;0;624;16493;2794
Midtjylland;27-8-2020;F;10;0;0;624;16503;2794
Nordjylland;27-8-2020;F;1;0;0;624;16504;2794
Sjælland;27-8-2020;F;2;0;0;624;16506;2794
Syddanmark;27-8-2020;F;6;0;1;624;16512;2795
Hovedstaden;27-8-2020;M;16;0;1;624;16528;2796
Midtjylland;27-8-2020;M;10;0;0;624;16538;2796
Nordjylland;27-8-2020;M;3;0;0;624;16541;2796
Sjælland;27-8-2020;M;5;0;0;624;16546;2796
Syddanmark;27-8-2020;M;9;0;0;624;16555;2796
Hovedstaden;28-8-2020;F;18;0;0;624;16573;2796
Midtjylland;28-8-2020;F;13;0;1;624;16586;2797
Nordjylland;28-8-2020;F;4;0;1;624;16590;2798
Sjælland;28-8-2020;F;4;0;1;624;16594;2799
Syddanmark;28-8-2020;F;7;0;0;624;16601;2799
Hovedstaden;28-8-2020;M;24;0;1;624;16625;2800
Midtjylland;28-8-2020;M;12;0;0;624;16637;2800
Nordjylland;28-8-2020;M;5;0;1;624;16642;2801
Sjælland;28-8-2020;M;5;0;0;624;16647;2801
Syddanmark;28-8-2020;M;15;0;0;624;16662;2801
Hovedstaden;29-8-2020;F;15;0;1;624;16677;2802
Midtjylland;29-8-2020;F;6;0;0;624;16683;2802
Nordjylland;29-8-2020;F;5;0;0;624;16688;2802
Sjælland;29-8-2020;F;1;0;0;624;16689;2802
Syddanmark;29-8-2020;F;10;0;0;624;16699;2802
Hovedstaden;29-8-2020;M;22;0;2;624;16721;2804
Midtjylland;29-8-2020;M;12;0;1;624;16733;2805
Nordjylland;29-8-2020;M;6;0;0;624;16739;2805
Sjælland;29-8-2020;M;1;0;0;624;16740;2805
Syddanmark;29-8-2020;M;4;0;0;624;16744;2805
Hovedstaden;30-8-2020;F;23;0;4;624;16767;2809
Midtjylland;30-8-2020;F;11;0;1;624;16778;2810
Nordjylland;30-8-2020;F;3;0;0;624;16781;2810
Sjælland;30-8-2020;F;1;0;0;624;16782;2810
Syddanmark;30-8-2020;F;11;0;1;624;16793;2811
Hovedstaden;30-8-2020;M;27;0;1;624;16820;2812
Midtjylland;30-8-2020;M;12;0;0;624;16832;2812
Nordjylland;30-8-2020;M;3;0;0;624;16835;2812
Sjælland;30-8-2020;M;4;0;0;624;16839;2812
Syddanmark;30-8-2020;M;8;0;0;624;16847;2812
Hovedstaden;31-8-2020;F;30;0;0;624;16877;2812
Midtjylland;31-8-2020;F;10;0;0;624;16887;2812
Sjælland;31-8-2020;F;2;0;0;624;16889;2812
Syddanmark;31-8-2020;F;14;0;2;624;16903;2814
Hovedstaden;31-8-2020;M;36;0;0;624;16939;2814
Midtjylland;31-8-2020;M;8;0;1;624;16947;2815
Nordjylland;31-8-2020;M;3;0;0;624;16950;2815
Sjælland;31-8-2020;M;7;0;0;624;16957;2815
Syddanmark;31-8-2020;M;8;0;1;624;16965;2816
Hovedstaden;1-9-2020;F;39;0;1;624;17004;2817
Midtjylland;1-9-2020;F;19;0;0;624;17023;2817
Nordjylland;1-9-2020;F;3;0;0;624;17026;2817
Sjælland;1-9-2020;F;6;0;0;624;17032;2817
Syddanmark;1-9-2020;F;26;0;1;624;17058;2818
Hovedstaden;1-9-2020;M;52;0;1;624;17110;2819
Midtjylland;1-9-2020;M;14;0;0;624;17124;2819
Nordjylland;1-9-2020;M;4;0;0;624;17128;2819
Sjælland;1-9-2020;M;10;0;0;624;17138;2819
Syddanmark;1-9-2020;M;25;0;2;624;17163;2821
Hovedstaden;2-9-2020;F;37;0;3;624;17200;2824
Midtjylland;2-9-2020;F;6;0;0;624;17206;2824
Nordjylland;2-9-2020;F;2;0;0;624;17208;2824
Sjælland;2-9-2020;F;5;0;0;624;17213;2824
Syddanmark;2-9-2020;F;18;0;0;624;17231;2824
Hovedstaden;2-9-2020;M;48;0;8;624;17279;2832
Midtjylland;2-9-2020;M;11;0;1;624;17290;2833
Nordjylland;2-9-2020;M;1;0;0;624;17291;2833
Sjælland;2-9-2020;M;9;0;0;624;17300;2833
Syddanmark;2-9-2020;M;18;0;1;624;17318;2834
Hovedstaden;3-9-2020;F;53;0;3;624;17371;2837
Midtjylland;3-9-2020;F;10;0;1;624;17381;2838
Nordjylland;3-9-2020;F;4;0;0;624;17385;2838
Sjælland;3-9-2020;F;6;0;0;624;17391;2838
Syddanmark;3-9-2020;F;20;0;0;624;17411;2838
Hovedstaden;3-9-2020;M;62;0;3;624;17473;2841
Midtjylland;3-9-2020;M;6;0;1;624;17479;2842
Nordjylland;3-9-2020;M;7;0;0;624;17486;2842
Sjælland;3-9-2020;M;9;0;1;624;17495;2843
Syddanmark;3-9-2020;M;15;0;0;624;17510;2843
Hovedstaden;4-9-2020;F;68;1;3;625;17578;2846
Midtjylland;4-9-2020;F;10;0;0;625;17588;2846
Nordjylland;4-9-2020;F;8;0;0;625;17596;2846
Sjælland;4-9-2020;F;8;0;1;625;17604;2847
Syddanmark;4-9-2020;F;12;0;0;625;17616;2847
Hovedstaden;4-9-2020;M;46;1;1;626;17662;2848
Midtjylland;4-9-2020;M;11;0;2;626;17673;2850
Nordjylland;4-9-2020;M;7;0;1;626;17680;2851
Sjælland;4-9-2020;M;15;0;1;626;17695;2852
Syddanmark;4-9-2020;M;14;0;0;626;17709;2852
Hovedstaden;5-9-2020;F;49;0;3;626;17758;2855
Midtjylland;5-9-2020;F;8;0;0;626;17766;2855
Nordjylland;5-9-2020;F;4;0;2;626;17770;2857
Sjælland;5-9-2020;F;5;0;0;626;17775;2857
Syddanmark;5-9-2020;F;24;0;0;626;17799;2857
Hovedstaden;5-9-2020;M;54;0;1;626;17853;2858
Midtjylland;5-9-2020;M;6;0;1;626;17859;2859
Nordjylland;5-9-2020;M;8;0;0;626;17867;2859
Sjælland;5-9-2020;M;12;0;0;626;17879;2859
Syddanmark;5-9-2020;M;27;0;2;626;17906;2861
Hovedstaden;6-9-2020;F;89;1;2;627;17995;2863
Midtjylland;6-9-2020;F;13;0;1;627;18008;2864
Nordjylland;6-9-2020;F;7;0;0;627;18015;2864
Sjælland;6-9-2020;F;9;0;1;627;18024;2865
Syddanmark;6-9-2020;F;9;0;0;627;18033;2865
Hovedstaden;6-9-2020;M;62;0;3;627;18095;2868
Midtjylland;6-9-2020;M;5;0;1;627;18100;2869
Nordjylland;6-9-2020;M;9;0;1;627;18109;2870
Sjælland;6-9-2020;M;9;0;0;627;18118;2870
Syddanmark;6-9-2020;M;10;0;0;627;18128;2870
Hovedstaden;7-9-2020;F;79;0;3;627;18207;2873
Midtjylland;7-9-2020;F;14;0;2;627;18221;2875
Nordjylland;7-9-2020;F;16;0;2;627;18237;2877
Sjælland;7-9-2020;F;41;0;2;627;18278;2879
Syddanmark;7-9-2020;F;13;0;0;627;18291;2879
Hovedstaden;7-9-2020;M;79;1;3;628;18370;2882
Midtjylland;7-9-2020;M;6;0;0;628;18376;2882
Nordjylland;7-9-2020;M;11;0;0;628;18387;2882
Sjælland;7-9-2020;M;25;0;1;628;18412;2883
Syddanmark;7-9-2020;M;11;0;0;628;18423;2883
Hovedstaden;8-9-2020;F;75;0;3;628;18498;2886
Midtjylland;8-9-2020;F;26;0;3;628;18524;2889
Nordjylland;8-9-2020;F;11;0;1;628;18535;2890
Sjælland;8-9-2020;F;25;0;1;628;18560;2891
Syddanmark;8-9-2020;F;32;0;0;628;18592;2891
Hovedstaden;8-9-2020;M;82;0;2;628;18674;2893
Midtjylland;8-9-2020;M;15;0;0;628;18689;2893
Nordjylland;8-9-2020;M;13;1;1;629;18702;2894
Sjælland;8-9-2020;M;25;0;1;629;18727;2895
Syddanmark;8-9-2020;M;23;1;2;630;18750;2897
Hovedstaden;9-9-2020;F;67;0;3;630;18817;2900
Midtjylland;9-9-2020;F;16;0;1;630;18833;2901
Nordjylland;9-9-2020;F;14;0;0;630;18847;2901
Sjælland;9-9-2020;F;7;0;0;630;18854;2901
Syddanmark;9-9-2020;F;30;0;0;630;18884;2901
Hovedstaden;9-9-2020;M;90;1;5;631;18974;2906
Midtjylland;9-9-2020;M;12;0;1;631;18986;2907
Nordjylland;9-9-2020;M;15;0;0;631;19001;2907
Sjælland;9-9-2020;M;17;0;1;631;19018;2908
Syddanmark;9-9-2020;M;25;0;2;631;19043;2910
Hovedstaden;10-9-2020;F;101;2;5;633;19144;2915
Midtjylland;10-9-2020;F;8;0;0;633;19152;2915
Nordjylland;10-9-2020;F;18;0;0;633;19170;2915
Sjælland;10-9-2020;F;30;0;1;633;19200;2916
Syddanmark;10-9-2020;F;35;0;1;633;19235;2917
Hovedstaden;10-9-2020;M;96;2;8;635;19331;2925
Midtjylland;10-9-2020;M;20;0;0;635;19351;2925
Nordjylland;10-9-2020;M;19;1;1;636;19370;2926
Sjælland;10-9-2020;M;20;0;0;636;19390;2926
Syddanmark;10-9-2020;M;20;0;2;636;19410;2928
Hovedstaden;11-9-2020;F;93;1;3;637;19503;2931
Midtjylland;11-9-2020;F;28;0;0;637;19531;2931
Nordjylland;11-9-2020;F;21;0;1;637;19552;2932
Sjælland;11-9-2020;F;10;0;0;637;19562;2932
Syddanmark;11-9-2020;F;21;0;0;637;19583;2932
Hovedstaden;11-9-2020;M;76;0;4;637;19659;2936
Midtjylland;11-9-2020;M;43;0;5;637;19702;2941
Nordjylland;11-9-2020;M;22;0;0;637;19724;2941
Sjælland;11-9-2020;M;11;0;0;637;19735;2941
Syddanmark;11-9-2020;M;21;0;1;637;19756;2942
Hovedstaden;12-9-2020;F;89;0;3;637;19845;2945
Midtjylland;12-9-2020;F;14;0;1;637;19859;2946
Nordjylland;12-9-2020;F;12;0;0;637;19871;2946
Sjælland;12-9-2020;F;11;0;0;637;19882;2946
Syddanmark;12-9-2020;F;20;0;0;637;19902;2946
Hovedstaden;12-9-2020;M;85;2;4;639;19987;2950
Midtjylland;12-9-2020;M;15;0;1;639;20002;2951
Nordjylland;12-9-2020;M;19;1;1;640;20021;2952
Sjælland;12-9-2020;M;12;0;0;640;20033;2952
Syddanmark;12-9-2020;M;24;0;1;640;20057;2953
Hovedstaden;13-9-2020;F;82;0;6;640;20139;2959
Midtjylland;13-9-2020;F;7;0;0;640;20146;2959
Nordjylland;13-9-2020;F;19;0;0;640;20165;2959
Sjælland;13-9-2020;F;8;1;1;641;20173;2960
Syddanmark;13-9-2020;F;20;0;1;641;20193;2961
Hovedstaden;13-9-2020;M;87;1;4;642;20280;2965
Midtjylland;13-9-2020;M;9;0;0;642;20289;2965
Nordjylland;13-9-2020;M;23;0;3;642;20312;2968
Sjælland;13-9-2020;M;9;0;1;642;20321;2969
Syddanmark;13-9-2020;M;32;1;1;643;20353;2970
Hovedstaden;14-9-2020;F;114;0;3;643;20467;2973
Midtjylland;14-9-2020;F;18;0;0;643;20485;2973
Nordjylland;14-9-2020;F;19;0;1;643;20504;2974
Sjælland;14-9-2020;F;16;0;2;643;20520;2976
Syddanmark;14-9-2020;F;20;0;1;643;20540;2977
Hovedstaden;14-9-2020;M;108;0;5;643;20648;2982
Midtjylland;14-9-2020;M;18;0;1;643;20666;2983
Nordjylland;14-9-2020;M;29;1;3;644;20695;2986
Sjælland;14-9-2020;M;15;0;0;644;20710;2986
Syddanmark;14-9-2020;M;23;0;1;644;20733;2987
Hovedstaden;15-9-2020;F;136;0;7;644;20869;2994
Midtjylland;15-9-2020;F;22;0;3;644;20891;2997
Nordjylland;15-9-2020;F;32;0;2;644;20923;2999
Sjælland;15-9-2020;F;17;0;0;644;20940;2999
Syddanmark;15-9-2020;F;29;0;1;644;20969;3000
Hovedstaden;15-9-2020;M;104;0;4;644;21073;3004
Midtjylland;15-9-2020;M;25;0;3;644;21098;3007
Nordjylland;15-9-2020;M;29;0;1;644;21127;3008
Sjælland;15-9-2020;M;20;0;3;644;21147;3011
Syddanmark;15-9-2020;M;21;0;0;644;21168;3011
Hovedstaden;16-9-2020;F;150;2;12;646;21318;3023
Midtjylland;16-9-2020;F;29;0;2;646;21347;3025
Nordjylland;16-9-2020;F;38;0;0;646;21385;3025
Sjælland;16-9-2020;F;30;0;0;646;21415;3025
Syddanmark;16-9-2020;F;33;0;0;646;21448;3025
Hovedstaden;16-9-2020;M;156;1;7;647;21604;3032
Midtjylland;16-9-2020;M;34;0;2;647;21638;3034
Nordjylland;16-9-2020;M;28;1;2;648;21666;3036
Sjælland;16-9-2020;M;16;0;2;648;21682;3038
Syddanmark;16-9-2020;M;35;0;2;648;21717;3040
Hovedstaden;17-9-2020;F;142;1;5;649;21859;3045
Midtjylland;17-9-2020;F;32;0;1;649;21891;3046
Nordjylland;17-9-2020;F;13;0;1;649;21904;3047
Sjælland;17-9-2020;F;23;0;1;649;21927;3048
Syddanmark;17-9-2020;F;27;0;0;649;21954;3048
Hovedstaden;17-9-2020;M;170;0;5;649;22124;3053
Midtjylland;17-9-2020;M;29;0;0;649;22153;3053
Nordjylland;17-9-2020;M;24;1;4;650;22177;3057
Sjælland;17-9-2020;M;21;0;0;650;22198;3057
Syddanmark;17-9-2020;M;35;0;1;650;22233;3058
Hovedstaden;18-9-2020;F;133;1;6;651;22366;3064
Midtjylland;18-9-2020;F;37;0;1;651;22403;3065
Nordjylland;18-9-2020;F;21;0;1;651;22424;3066
Sjælland;18-9-2020;F;21;0;0;651;22445;3066
Syddanmark;18-9-2020;F;29;0;3;651;22474;3069
Hovedstaden;18-9-2020;M;127;0;5;651;22601;3074
Midtjylland;18-9-2020;M;32;0;1;651;22633;3075
Nordjylland;18-9-2020;M;25;0;1;651;22658;3076
Sjælland;18-9-2020;M;27;0;1;651;22685;3077
Syddanmark;18-9-2020;M;23;0;0;651;22708;3077
Hovedstaden;19-9-2020;F;114;1;7;652;22822;3084
Midtjylland;19-9-2020;F;23;0;1;652;22845;3085
Nordjylland;19-9-2020;F;14;0;1;652;22859;3086
Sjælland;19-9-2020;F;20;0;1;652;22879;3087
Syddanmark;19-9-2020;F;35;0;2;652;22914;3089
Hovedstaden;19-9-2020;M;114;0;3;652;23028;3092
Midtjylland;19-9-2020;M;26;0;0;652;23054;3092
Nordjylland;19-9-2020;M;17;0;2;652;23071;3094
Sjælland;19-9-2020;M;28;0;2;652;23099;3096
Syddanmark;19-9-2020;M;25;0;1;652;23124;3097
Hovedstaden;20-9-2020;F;105;2;5;654;23229;3102
Midtjylland;20-9-2020;F;21;0;1;654;23250;3103
Nordjylland;20-9-2020;F;24;0;1;654;23274;3104
Sjælland;20-9-2020;F;24;0;0;654;23298;3104
Syddanmark;20-9-2020;F;20;0;2;654;23318;3106
Hovedstaden;20-9-2020;M;122;0;5;654;23440;3111
Midtjylland;20-9-2020;M;30;0;1;654;23470;3112
Nordjylland;20-9-2020;M;18;0;1;654;23488;3113
Sjælland;20-9-2020;M;22;0;0;654;23510;3113
Syddanmark;20-9-2020;M;22;0;1;654;23532;3114
Hovedstaden;21-9-2020;F;137;0;7;654;23669;3121
Midtjylland;21-9-2020;F;42;0;2;654;23711;3123
Nordjylland;21-9-2020;F;22;0;1;654;23733;3124
Sjælland;21-9-2020;F;34;0;1;654;23767;3125
Syddanmark;21-9-2020;F;30;0;1;654;23797;3126
Hovedstaden;21-9-2020;M;161;0;2;654;23958;3128
Midtjylland;21-9-2020;M;23;0;0;654;23981;3128
Nordjylland;21-9-2020;M;36;0;0;654;24017;3128
Sjælland;21-9-2020;M;22;0;1;654;24039;3129
Syddanmark;21-9-2020;M;28;0;0;654;24067;3129
Hovedstaden;22-9-2020;F;153;1;6;655;24220;3135
Midtjylland;22-9-2020;F;50;0;0;655;24270;3135
Nordjylland;22-9-2020;F;21;0;0;655;24291;3135
Sjælland;22-9-2020;F;29;0;0;655;24320;3135
Syddanmark;22-9-2020;F;34;0;1;655;24354;3136
Hovedstaden;22-9-2020;M;148;2;7;657;24502;3143
Midtjylland;22-9-2020;M;43;0;1;657;24545;3144
Nordjylland;22-9-2020;M;32;0;0;657;24577;3144
Sjælland;22-9-2020;M;39;0;2;657;24616;3146
Syddanmark;22-9-2020;M;38;1;3;658;24654;3149
Hovedstaden;23-9-2020;F;144;1;6;659;24798;3155
Midtjylland;23-9-2020;F;52;0;2;659;24850;3157
Nordjylland;23-9-2020;F;24;0;0;659;24874;3157
Sjælland;23-9-2020;F;49;0;2;659;24923;3159
Syddanmark;23-9-2020;F;39;0;1;659;24962;3160
Hovedstaden;23-9-2020;M;155;0;4;659;25117;3164
Midtjylland;23-9-2020;M;72;0;4;659;25189;3168
Nordjylland;23-9-2020;M;25;0;1;659;25214;3169
Sjælland;23-9-2020;M;46;2;5;661;25260;3174
Syddanmark;23-9-2020;M;45;0;1;661;25305;3175
Hovedstaden;24-9-2020;F;140;0;3;661;25445;3178
Midtjylland;24-9-2020;F;58;0;3;661;25503;3181
Nordjylland;24-9-2020;F;20;0;0;661;25523;3181
Sjælland;24-9-2020;F;41;0;1;661;25564;3182
Syddanmark;24-9-2020;F;43;0;4;661;25607;3186
Hovedstaden;24-9-2020;M;146;1;7;662;25753;3193
Midtjylland;24-9-2020;M;55;1;0;663;25808;3193
Nordjylland;24-9-2020;M;18;0;0;663;25826;3193
Sjælland;24-9-2020;M;40;0;2;663;25866;3195
Syddanmark;24-9-2020;M;37;0;5;663;25903;3200
Hovedstaden;25-9-2020;F;103;0;6;663;26006;3206
Midtjylland;25-9-2020;F;52;0;2;663;26058;3208
Nordjylland;25-9-2020;F;13;0;1;663;26071;3209
Sjælland;25-9-2020;F;31;0;2;663;26102;3211
Syddanmark;25-9-2020;F;40;0;0;663;26142;3211
Hovedstaden;25-9-2020;M;104;1;4;664;26246;3215
Midtjylland;25-9-2020;M;52;0;2;664;26298;3217
Nordjylland;25-9-2020;M;27;0;0;664;26325;3217
Sjælland;25-9-2020;M;34;0;2;664;26359;3219
Syddanmark;25-9-2020;M;32;0;1;664;26391;3220
Hovedstaden;26-9-2020;F;84;0;3;664;26475;3223
Midtjylland;26-9-2020;F;50;0;1;664;26525;3224
Nordjylland;26-9-2020;F;15;0;1;664;26540;3225
Sjælland;26-9-2020;F;29;0;2;664;26569;3227
Syddanmark;26-9-2020;F;18;0;1;664;26587;3228
Hovedstaden;26-9-2020;M;94;0;2;664;26681;3230
Midtjylland;26-9-2020;M;42;0;1;664;26723;3231
Nordjylland;26-9-2020;M;17;0;0;664;26740;3231
Sjælland;26-9-2020;M;24;0;2;664;26764;3233
Syddanmark;26-9-2020;M;20;0;0;664;26784;3233
Hovedstaden;27-9-2020;F;102;0;2;664;26886;3235
Midtjylland;27-9-2020;F;47;0;1;664;26933;3236
Nordjylland;27-9-2020;F;9;0;1;664;26942;3237
Sjælland;27-9-2020;F;23;0;0;664;26965;3237
Syddanmark;27-9-2020;F;14;0;0;664;26979;3237
Hovedstaden;27-9-2020;M;80;0;4;664;27059;3241
Midtjylland;27-9-2020;M;32;0;3;664;27091;3244
Nordjylland;27-9-2020;M;13;1;2;665;27104;3246
Sjælland;27-9-2020;M;16;0;0;665;27120;3246
Syddanmark;27-9-2020;M;21;0;0;665;27141;3246
Hovedstaden;28-9-2020;F;118;0;5;665;27259;3251
Midtjylland;28-9-2020;F;52;0;1;665;27311;3252
Nordjylland;28-9-2020;F;14;0;0;665;27325;3252
Sjælland;28-9-2020;F;28;0;0;665;27353;3252
Syddanmark;28-9-2020;F;33;0;2;665;27386;3254
Hovedstaden;28-9-2020;M;94;1;3;666;27480;3257
Midtjylland;28-9-2020;M;57;0;3;666;27537;3260
Nordjylland;28-9-2020;M;25;0;0;666;27562;3260
Sjælland;28-9-2020;M;34;0;1;666;27596;3261
Syddanmark;28-9-2020;M;26;0;2;666;27622;3263
Hovedstaden;29-9-2020;F;100;0;4;666;27722;3267
Midtjylland;29-9-2020;F;56;0;4;666;27778;3271
Nordjylland;29-9-2020;F;17;0;0;666;27795;3271
Sjælland;29-9-2020;F;28;0;0;666;27823;3271
Syddanmark;29-9-2020;F;27;1;1;667;27850;3272
Hovedstaden;29-9-2020;M;90;0;3;667;27940;3275
Midtjylland;29-9-2020;M;51;1;2;668;27991;3277
Nordjylland;29-9-2020;M;27;0;2;668;28018;3279
Sjælland;29-9-2020;M;24;0;1;668;28042;3280
Syddanmark;29-9-2020;M;29;0;1;668;28071;3281
Hovedstaden;30-9-2020;F;97;0;3;668;28168;3284
Midtjylland;30-9-2020;F;46;0;0;668;28214;3284
Nordjylland;30-9-2020;F;13;0;1;668;28227;3285
Sjælland;30-9-2020;F;28;0;3;668;28255;3288
Syddanmark;30-9-2020;F;20;0;1;668;28275;3289
Hovedstaden;30-9-2020;M;78;0;3;668;28353;3292
Midtjylland;30-9-2020;M;49;0;1;668;28402;3293
Nordjylland;30-9-2020;M;26;0;0;668;28428;3293
Sjælland;30-9-2020;M;31;0;0;668;28459;3293
Syddanmark;30-9-2020;M;46;0;1;668;28505;3294
Hovedstaden;1-10-2020;F;90;0;3;668;28595;3297
Midtjylland;1-10-2020;F;54;0;1;668;28649;3298
Nordjylland;1-10-2020;F;20;2;2;670;28669;3300
Sjælland;1-10-2020;F;30;0;0;670;28699;3300
Syddanmark;1-10-2020;F;25;1;0;671;28724;3300
Hovedstaden;1-10-2020;M;74;0;3;671;28798;3303
Midtjylland;1-10-2020;M;54;1;3;672;28852;3306
Nordjylland;1-10-2020;M;21;1;2;673;28873;3308
Sjælland;1-10-2020;M;26;0;0;673;28899;3308
Syddanmark;1-10-2020;M;33;0;2;673;28932;3310
Hovedstaden;2-10-2020;F;74;0;3;673;29006;3313
Midtjylland;2-10-2020;F;39;0;2;673;29045;3315
Nordjylland;2-10-2020;F;19;0;1;673;29064;3316
Sjælland;2-10-2020;F;21;0;0;673;29085;3316
Syddanmark;2-10-2020;F;20;0;0;673;29105;3316
Hovedstaden;2-10-2020;M;67;0;3;673;29172;3319
Midtjylland;2-10-2020;M;62;1;3;674;29234;3322
Nordjylland;2-10-2020;M;17;0;1;674;29251;3323
Sjælland;2-10-2020;M;20;0;1;674;29271;3324
Syddanmark;2-10-2020;M;27;0;0;674;29298;3324
Hovedstaden;3-10-2020;F;79;0;3;674;29377;3327
Midtjylland;3-10-2020;F;27;0;1;674;29404;3328
Nordjylland;3-10-2020;F;12;0;0;674;29416;3328
Sjælland;3-10-2020;F;17;0;0;674;29433;3328
Syddanmark;3-10-2020;F;29;0;0;674;29462;3328
Hovedstaden;3-10-2020;M;67;0;0;674;29529;3328
Midtjylland;3-10-2020;M;43;0;3;674;29572;3331
Nordjylland;3-10-2020;M;19;0;0;674;29591;3331
Sjælland;3-10-2020;M;15;0;0;674;29606;3331
Syddanmark;3-10-2020;M;30;0;0;674;29636;3331
Hovedstaden;4-10-2020;F;63;0;6;674;29699;3337
Midtjylland;4-10-2020;F;29;0;1;674;29728;3338
Nordjylland;4-10-2020;F;11;0;0;674;29739;3338
Sjælland;4-10-2020;F;13;0;0;674;29752;3338
Syddanmark;4-10-2020;F;21;1;0;675;29773;3338
Hovedstaden;4-10-2020;M;83;0;3;675;29856;3341
Midtjylland;4-10-2020;M;29;0;2;675;29885;3343
Nordjylland;4-10-2020;M;19;0;1;675;29904;3344
Sjælland;4-10-2020;M;17;0;2;675;29921;3346
Syddanmark;4-10-2020;M;21;0;2;675;29942;3348
Hovedstaden;5-10-2020;F;89;1;5;676;30031;3353
Midtjylland;5-10-2020;F;55;0;4;676;30086;3357
Nordjylland;5-10-2020;F;19;0;0;676;30105;3357
Sjælland;5-10-2020;F;23;0;0;676;30128;3357
Syddanmark;5-10-2020;F;33;0;0;676;30161;3357
Hovedstaden;5-10-2020;M;72;2;8;678;30233;3365
Midtjylland;5-10-2020;M;50;0;3;678;30283;3368
Nordjylland;5-10-2020;M;41;0;1;678;30324;3369
Sjælland;5-10-2020;M;17;0;2;678;30341;3371
Syddanmark;5-10-2020;M;28;0;0;678;30369;3371
Hovedstaden;6-10-2020;F;91;1;2;679;30460;3373
Midtjylland;6-10-2020;F;35;0;1;679;30495;3374
Nordjylland;6-10-2020;F;15;0;1;679;30510;3375
Sjælland;6-10-2020;F;19;0;0;679;30529;3375
Syddanmark;6-10-2020;F;23;0;1;679;30552;3376
Hovedstaden;6-10-2020;M;103;0;3;679;30655;3379
Midtjylland;6-10-2020;M;73;0;3;679;30728;3382
Nordjylland;6-10-2020;M;16;0;1;679;30744;3383
Sjælland;6-10-2020;M;21;0;1;679;30765;3384
Syddanmark;6-10-2020;M;30;0;1;679;30795;3385
Hovedstaden;7-10-2020;F;80;3;7;682;30875;3392
Midtjylland;7-10-2020;F;47;0;2;682;30922;3394
Nordjylland;7-10-2020;F;24;0;1;682;30946;3395
Sjælland;7-10-2020;F;18;0;0;682;30964;3395
Syddanmark;7-10-2020;F;32;1;1;683;30996;3396
Hovedstaden;7-10-2020;M;78;1;5;684;31074;3401
Midtjylland;7-10-2020;M;105;0;4;684;31179;3405
Nordjylland;7-10-2020;M;25;0;0;684;31204;3405
Sjælland;7-10-2020;M;19;0;1;684;31223;3406
Syddanmark;7-10-2020;M;24;2;1;686;31247;3407
Hovedstaden;8-10-2020;F;73;0;1;686;31320;3408
Midtjylland;8-10-2020;F;67;0;2;686;31387;3410
Nordjylland;8-10-2020;F;20;0;0;686;31407;3410
Sjælland;8-10-2020;F;15;1;2;687;31422;3412
Syddanmark;8-10-2020;F;27;0;0;687;31449;3412
Hovedstaden;8-10-2020;M;80;0;3;687;31529;3415
Midtjylland;8-10-2020;M;69;0;3;687;31598;3418
Nordjylland;8-10-2020;M;30;0;2;687;31628;3420
Sjælland;8-10-2020;M;13;0;0;687;31641;3420
Syddanmark;8-10-2020;M;28;0;1;687;31669;3421
Hovedstaden;9-10-2020;F;72;1;4;688;31741;3425
Midtjylland;9-10-2020;F;55;0;4;688;31796;3429
Nordjylland;9-10-2020;F;22;0;0;688;31818;3429
Sjælland;9-10-2020;F;16;0;0;688;31834;3429
Syddanmark;9-10-2020;F;34;0;1;688;31868;3430
Hovedstaden;9-10-2020;M;79;0;3;688;31947;3433
Midtjylland;9-10-2020;M;61;0;2;688;32008;3435
Nordjylland;9-10-2020;M;21;0;0;688;32029;3435
Sjælland;9-10-2020;M;14;0;1;688;32043;3436
Syddanmark;9-10-2020;M;37;2;3;690;32080;3439
Hovedstaden;10-10-2020;F;48;0;3;690;32128;3442
Midtjylland;10-10-2020;F;39;0;1;690;32167;3443
Nordjylland;10-10-2020;F;14;0;1;690;32181;3444
Sjælland;10-10-2020;F;13;0;0;690;32194;3444
Syddanmark;10-10-2020;F;16;0;0;690;32210;3444
Hovedstaden;10-10-2020;M;60;0;5;690;32270;3449
Midtjylland;10-10-2020;M;48;0;3;690;32318;3452
Nordjylland;10-10-2020;M;18;0;1;690;32336;3453
Sjælland;10-10-2020;M;12;0;1;690;32348;3454
Syddanmark;10-10-2020;M;13;0;0;690;32361;3454
Hovedstaden;11-10-2020;F;54;1;6;691;32415;3460
Midtjylland;11-10-2020;F;34;0;1;691;32449;3461
Nordjylland;11-10-2020;F;12;0;0;691;32461;3461
Sjælland;11-10-2020;F;16;0;1;691;32477;3462
Syddanmark;11-10-2020;F;18;0;0;691;32495;3462
Hovedstaden;11-10-2020;M;44;0;1;691;32539;3463
Midtjylland;11-10-2020;M;32;0;2;691;32571;3465
Nordjylland;11-10-2020;M;18;1;1;692;32589;3466
Sjælland;11-10-2020;M;13;0;0;692;32602;3466
Syddanmark;11-10-2020;M;15;0;2;692;32617;3468
Hovedstaden;12-10-2020;F;65;1;3;693;32682;3471
Midtjylland;12-10-2020;F;62;1;3;694;32744;3474
Nordjylland;12-10-2020;F;21;0;0;694;32765;3474
Sjælland;12-10-2020;F;17;0;2;694;32782;3476
Syddanmark;12-10-2020;F;39;0;2;694;32821;3478
Hovedstaden;12-10-2020;M;77;1;4;695;32898;3482
Midtjylland;12-10-2020;M;66;0;2;695;32964;3484
Nordjylland;12-10-2020;M;24;0;3;695;32988;3487
Sjælland;12-10-2020;M;52;0;2;695;33040;3489
Syddanmark;12-10-2020;M;34;1;4;696;33074;3493
Hovedstaden;13-10-2020;F;88;0;4;696;33162;3497
Midtjylland;13-10-2020;F;42;0;5;696;33204;3502
Nordjylland;13-10-2020;F;21;1;0;697;33225;3502
Sjælland;13-10-2020;F;13;0;2;697;33238;3504
Syddanmark;13-10-2020;F;44;0;4;697;33282;3508
Hovedstaden;13-10-2020;M;69;1;4;698;33351;3512
Midtjylland;13-10-2020;M;53;0;0;698;33404;3512
Nordjylland;13-10-2020;M;34;0;0;698;33438;3512
Sjælland;13-10-2020;M;11;0;0;698;33449;3512
Syddanmark;13-10-2020;M;50;1;1;699;33499;3513
Hovedstaden;14-10-2020;F;98;0;6;699;33597;3519
Midtjylland;14-10-2020;F;46;0;2;699;33643;3521
Nordjylland;14-10-2020;F;31;1;1;700;33674;3522
Sjælland;14-10-2020;F;11;0;0;700;33685;3522
Syddanmark;14-10-2020;F;34;0;0;700;33719;3522
Hovedstaden;14-10-2020;M;103;2;8;702;33822;3530
Midtjylland;14-10-2020;M;50;1;2;703;33872;3532
Nordjylland;14-10-2020;M;31;1;3;704;33903;3535
Sjælland;14-10-2020;M;25;0;0;704;33928;3535
Syddanmark;14-10-2020;M;40;0;2;704;33968;3537
Hovedstaden;15-10-2020;F;94;0;4;704;34062;3541
Midtjylland;15-10-2020;F;53;0;1;704;34115;3542
Nordjylland;15-10-2020;F;18;0;0;704;34133;3542
Sjælland;15-10-2020;F;13;0;2;704;34146;3544
Syddanmark;15-10-2020;F;38;0;3;704;34184;3547
Hovedstaden;15-10-2020;M;87;1;7;705;34271;3554
Midtjylland;15-10-2020;M;58;0;3;705;34329;3557
Nordjylland;15-10-2020;M;15;0;0;705;34344;3557
Sjælland;15-10-2020;M;26;0;1;705;34370;3558
Syddanmark;15-10-2020;M;47;0;1;705;34417;3559
Hovedstaden;16-10-2020;F;106;1;7;706;34523;3566
Midtjylland;16-10-2020;F;60;0;1;706;34583;3567
Nordjylland;16-10-2020;F;28;0;0;706;34611;3567
Sjælland;16-10-2020;F;25;0;0;706;34636;3567
Syddanmark;16-10-2020;F;32;0;1;706;34668;3568
Hovedstaden;16-10-2020;M;81;1;3;707;34749;3571
Midtjylland;16-10-2020;M;44;0;1;707;34793;3572
Nordjylland;16-10-2020;M;21;1;1;708;34814;3573
Sjælland;16-10-2020;M;23;0;4;708;34837;3577
Syddanmark;16-10-2020;M;45;0;4;708;34882;3581
Hovedstaden;17-10-2020;F;103;0;6;708;34985;3587
Midtjylland;17-10-2020;F;36;0;1;708;35021;3588
Nordjylland;17-10-2020;F;21;0;0;708;35042;3588
Sjælland;17-10-2020;F;12;0;0;708;35054;3588
Syddanmark;17-10-2020;F;40;0;0;708;35094;3588
Hovedstaden;17-10-2020;M;114;0;7;708;35208;3595
Midtjylland;17-10-2020;M;39;0;2;708;35247;3597
Nordjylland;17-10-2020;M;21;0;3;708;35268;3600
Sjælland;17-10-2020;M;16;0;0;708;35284;3600
Syddanmark;17-10-2020;M;29;0;0;708;35313;3600
Hovedstaden;18-10-2020;F;103;0;6;708;35416;3606
Midtjylland;18-10-2020;F;39;0;3;708;35455;3609
Nordjylland;18-10-2020;F;19;0;1;708;35474;3610
Sjælland;18-10-2020;F;20;0;0;708;35494;3610
Syddanmark;18-10-2020;F;44;0;2;708;35538;3612
Hovedstaden;18-10-2020;M;123;0;8;708;35661;3620
Midtjylland;18-10-2020;M;32;0;3;708;35693;3623
Nordjylland;18-10-2020;M;24;1;3;709;35717;3626
Sjælland;18-10-2020;M;15;0;0;709;35732;3626
Syddanmark;18-10-2020;M;33;2;3;711;35765;3629
Hovedstaden;19-10-2020;F;144;0;6;711;35909;3635
Midtjylland;19-10-2020;F;65;2;2;713;35974;3637
Nordjylland;19-10-2020;F;37;1;1;714;36011;3638
Sjælland;19-10-2020;F;32;0;0;714;36043;3638
Syddanmark;19-10-2020;F;51;0;2;714;36094;3640
Hovedstaden;19-10-2020;M;149;1;5;715;36243;3645
Midtjylland;19-10-2020;M;74;0;0;715;36317;3645
Nordjylland;19-10-2020;M;35;0;0;715;36352;3645
Sjælland;19-10-2020;M;36;0;1;715;36388;3646
Syddanmark;19-10-2020;M;64;0;2;715;36452;3648
Hovedstaden;20-10-2020;F;155;0;3;715;36607;3651
Midtjylland;20-10-2020;F;80;0;2;715;36687;3653
Nordjylland;20-10-2020;F;43;1;2;716;36730;3655
Sjælland;20-10-2020;F;34;0;4;716;36764;3659
Syddanmark;20-10-2020;F;58;0;5;716;36822;3664
Hovedstaden;20-10-2020;M;163;2;8;718;36985;3672
Midtjylland;20-10-2020;M;111;0;3;718;37096;3675
Nordjylland;20-10-2020;M;41;2;0;720;37137;3675
Sjælland;20-10-2020;M;36;0;2;720;37173;3677
Syddanmark;20-10-2020;M;59;0;3;720;37232;3680
Hovedstaden;21-10-2020;F;152;1;5;721;37384;3685
Midtjylland;21-10-2020;F;114;0;6;721;37498;3691
Nordjylland;21-10-2020;F;45;0;1;721;37543;3692
Sjælland;21-10-2020;F;37;0;2;721;37580;3694
Syddanmark;21-10-2020;F;46;0;0;721;37626;3694
Hovedstaden;21-10-2020;M;178;2;8;723;37804;3702
Midtjylland;21-10-2020;M;119;0;4;723;37923;3706
Nordjylland;21-10-2020;M;47;1;1;724;37970;3707
Sjælland;21-10-2020;M;39;0;0;724;38009;3707
Syddanmark;21-10-2020;M;70;0;0;724;38079;3707
Hovedstaden;22-10-2020;F;202;2;9;726;38281;3716
Midtjylland;22-10-2020;F;77;1;1;727;38358;3717
Nordjylland;22-10-2020;F;49;0;0;727;38407;3717
Sjælland;22-10-2020;F;36;0;1;727;38443;3718
Syddanmark;22-10-2020;F;58;0;2;727;38501;3720
Hovedstaden;22-10-2020;M;205;1;8;728;38706;3728
Midtjylland;22-10-2020;M;74;0;3;728;38780;3731
Nordjylland;22-10-2020;M;53;0;1;728;38833;3732
Sjælland;22-10-2020;M;39;0;0;728;38872;3732
Syddanmark;22-10-2020;M;73;1;3;729;38945;3735
Hovedstaden;23-10-2020;F;181;0;8;729;39126;3743
Midtjylland;23-10-2020;F;74;0;0;729;39200;3743
Nordjylland;23-10-2020;F;54;0;0;729;39254;3743
Sjælland;23-10-2020;F;37;0;0;729;39291;3743
Syddanmark;23-10-2020;F;56;0;1;729;39347;3744
Hovedstaden;23-10-2020;M;189;0;3;729;39536;3747
Midtjylland;23-10-2020;M;100;0;1;729;39636;3748
Nordjylland;23-10-2020;M;63;0;3;729;39699;3751
Sjælland;23-10-2020;M;42;0;3;729;39741;3754
Syddanmark;23-10-2020;M;64;0;4;729;39805;3758
Hovedstaden;24-10-2020;F;186;2;7;731;39991;3765
Midtjylland;24-10-2020;F;69;0;4;731;40060;3769
Nordjylland;24-10-2020;F;58;0;2;731;40118;3771
Sjælland;24-10-2020;F;41;0;1;731;40159;3772
Syddanmark;24-10-2020;F;44;0;1;731;40203;3773
Hovedstaden;24-10-2020;M;199;1;9;732;40402;3782
Midtjylland;24-10-2020;M;75;0;2;732;40477;3784
Nordjylland;24-10-2020;M;46;0;2;732;40523;3786
Sjælland;24-10-2020;M;48;0;5;732;40571;3791
Syddanmark;24-10-2020;M;53;0;1;732;40624;3792
Hovedstaden;25-10-2020;F;210;0;9;732;40834;3801
Midtjylland;25-10-2020;F;81;0;0;732;40915;3801
Nordjylland;25-10-2020;F;66;0;3;732;40981;3804
Sjælland;25-10-2020;F;44;0;2;732;41025;3806
Syddanmark;25-10-2020;F;67;0;2;732;41092;3808
Hovedstaden;25-10-2020;M;229;0;6;732;41321;3814
Midtjylland;25-10-2020;M;75;0;0;732;41396;3814
Nordjylland;25-10-2020;M;42;0;1;732;41438;3815
Sjælland;25-10-2020;M;35;0;1;732;41473;3816
Syddanmark;25-10-2020;M;67;0;2;732;41540;3818
Hovedstaden;26-10-2020;F;230;0;11;732;41770;3829
Midtjylland;26-10-2020;F;87;0;3;732;41857;3832
Nordjylland;26-10-2020;F;54;1;2;733;41911;3834
Sjælland;26-10-2020;F;46;0;4;733;41957;3838
Syddanmark;26-10-2020;F;77;0;1;733;42034;3839
Hovedstaden;26-10-2020;M;215;0;5;733;42249;3844
Midtjylland;26-10-2020;M;75;0;3;733;42324;3847
Nordjylland;26-10-2020;M;78;0;4;733;42402;3851
Sjælland;26-10-2020;M;53;0;2;733;42455;3853
Syddanmark;26-10-2020;M;89;0;6;733;42544;3859
Hovedstaden;27-10-2020;F;301;1;13;734;42845;3872
Midtjylland;27-10-2020;F;113;0;1;734;42958;3873
Nordjylland;27-10-2020;F;69;0;3;734;43027;3876
Sjælland;27-10-2020;F;67;0;2;734;43094;3878
Syddanmark;27-10-2020;F;69;0;4;734;43163;3882
Hovedstaden;27-10-2020;M;272;0;5;734;43435;3887
Midtjylland;27-10-2020;M;127;0;6;734;43562;3893
Nordjylland;27-10-2020;M;79;2;4;736;43641;3897
Sjælland;27-10-2020;M;68;0;0;736;43709;3897
Syddanmark;27-10-2020;M;76;0;7;736;43785;3904
Hovedstaden;28-10-2020;F;258;0;10;736;44043;3914
Midtjylland;28-10-2020;F;122;1;5;737;44165;3919
Nordjylland;28-10-2020;F;61;0;3;737;44226;3922
Sjælland;28-10-2020;F;67;0;0;737;44293;3922
Syddanmark;28-10-2020;F;76;0;6;737;44369;3928
Hovedstaden;28-10-2020;M;271;3;10;740;44640;3938
Midtjylland;28-10-2020;M;108;0;4;740;44748;3942
Nordjylland;28-10-2020;M;55;0;4;740;44803;3946
Sjælland;28-10-2020;M;74;1;1;741;44877;3947
Syddanmark;28-10-2020;M;111;0;3;741;44988;3950
Hovedstaden;29-10-2020;F;220;1;5;742;45208;3955
Midtjylland;29-10-2020;F;57;0;5;742;45265;3960
Nordjylland;29-10-2020;F;50;0;2;742;45315;3962
Sjælland;29-10-2020;F;53;0;3;742;45368;3965
Syddanmark;29-10-2020;F;73;0;1;742;45441;3966
Hovedstaden;29-10-2020;M;239;2;9;744;45680;3975
Midtjylland;29-10-2020;M;84;0;1;744;45764;3976
Nordjylland;29-10-2020;M;70;0;2;744;45834;3978
Sjælland;29-10-2020;M;67;1;2;745;45901;3980
Syddanmark;29-10-2020;M;99;1;6;746;46000;3986
Hovedstaden;30-10-2020;F;239;0;7;746;46239;3993
Midtjylland;30-10-2020;F;98;0;3;746;46337;3996
Nordjylland;30-10-2020;F;57;0;1;746;46394;3997
Sjælland;30-10-2020;F;83;0;2;746;46477;3999
Syddanmark;30-10-2020;F;57;0;3;746;46534;4002
Hovedstaden;30-10-2020;M;255;1;11;747;46789;4013
Midtjylland;30-10-2020;M;97;3;5;750;46886;4018
Nordjylland;30-10-2020;M;56;0;3;750;46942;4021
Sjælland;30-10-2020;M;69;1;2;751;47011;4023
Syddanmark;30-10-2020;M;70;0;1;751;47081;4024
Hovedstaden;31-10-2020;F;246;1;7;752;47327;4031
Midtjylland;31-10-2020;F;91;0;1;752;47418;4032
Nordjylland;31-10-2020;F;48;0;0;752;47466;4032
Sjælland;31-10-2020;F;56;0;3;752;47522;4035
Syddanmark;31-10-2020;F;41;1;2;753;47563;4037
Hovedstaden;31-10-2020;M;258;0;12;753;47821;4049
Midtjylland;31-10-2020;M;78;0;3;753;47899;4052
Nordjylland;31-10-2020;M;48;0;0;753;47947;4052
Sjælland;31-10-2020;M;52;0;0;753;47999;4052
Syddanmark;31-10-2020;M;58;0;1;753;48057;4053
Hovedstaden;1-11-2020;F;235;1;9;754;48292;4062
Midtjylland;1-11-2020;F;88;1;5;755;48380;4067
Nordjylland;1-11-2020;F;50;0;1;755;48430;4068
Sjælland;1-11-2020;F;41;0;1;755;48471;4069
Syddanmark;1-11-2020;F;75;2;4;757;48546;4073
Hovedstaden;1-11-2020;M;229;0;9;757;48775;4082
Midtjylland;1-11-2020;M;84;0;2;757;48859;4084
Nordjylland;1-11-2020;M;45;1;2;758;48904;4086
Sjælland;1-11-2020;M;43;0;3;758;48947;4089
Syddanmark;1-11-2020;M;64;0;3;758;49011;4092
Hovedstaden;2-11-2020;F;318;2;9;760;49329;4101
Midtjylland;2-11-2020;F;101;0;3;760;49430;4104
Nordjylland;2-11-2020;F;59;1;2;761;49489;4106
Sjælland;2-11-2020;F;90;0;2;761;49579;4108
Syddanmark;2-11-2020;F;89;1;3;762;49668;4111
Hovedstaden;2-11-2020;M;286;1;7;763;49954;4118
Midtjylland;2-11-2020;M;105;0;3;763;50059;4121
Nordjylland;2-11-2020;M;57;0;0;763;50116;4121
Sjælland;2-11-2020;M;93;0;1;763;50209;4122
Syddanmark;2-11-2020;M;73;0;5;763;50282;4127
Hovedstaden;3-11-2020;F;304;2;14;765;50586;4141
Midtjylland;3-11-2020;F;109;0;0;765;50695;4141
Nordjylland;3-11-2020;F;75;0;4;765;50770;4145
Sjælland;3-11-2020;F;78;1;5;766;50848;4150
Syddanmark;3-11-2020;F;78;0;7;766;50926;4157
Hovedstaden;3-11-2020;M;275;0;10;766;51201;4167
Midtjylland;3-11-2020;M;104;0;5;766;51305;4172
Nordjylland;3-11-2020;M;62;1;3;767;51367;4175
Sjælland;3-11-2020;M;68;0;2;767;51435;4177
Syddanmark;3-11-2020;M;103;0;2;767;51538;4179
Hovedstaden;4-11-2020;F;278;0;10;767;51816;4189
Midtjylland;4-11-2020;F;126;1;2;768;51942;4191
Nordjylland;4-11-2020;F;39;0;1;768;51981;4192
Sjælland;4-11-2020;F;97;3;6;771;52078;4198
Syddanmark;4-11-2020;F;75;0;3;771;52153;4201
Hovedstaden;4-11-2020;M;302;1;11;772;52455;4212
Midtjylland;4-11-2020;M;108;1;5;773;52563;4217
Nordjylland;4-11-2020;M;44;0;1;773;52607;4218
Sjælland;4-11-2020;M;75;1;6;774;52682;4224
Syddanmark;4-11-2020;M;97;0;4;774;52779;4228
Hovedstaden;5-11-2020;F;239;2;9;776;53018;4237
Midtjylland;5-11-2020;F;102;0;4;776;53120;4241
Nordjylland;5-11-2020;F;45;1;3;777;53165;4244
Sjælland;5-11-2020;F;61;0;4;777;53226;4248
Syddanmark;5-11-2020;F;69;0;5;777;53295;4253
Hovedstaden;5-11-2020;M;233;1;6;778;53528;4259
Midtjylland;5-11-2020;M;81;0;6;778;53609;4265
Nordjylland;5-11-2020;M;38;1;1;779;53647;4266
Sjælland;5-11-2020;M;79;0;4;779;53726;4270
Syddanmark;5-11-2020;M;81;0;3;779;53807;4273
Hovedstaden;6-11-2020;F;209;0;10;779;54016;4283
Midtjylland;6-11-2020;F;77;2;2;781;54093;4285
Nordjylland;6-11-2020;F;29;0;1;781;54122;4286
Sjælland;6-11-2020;F;71;0;1;781;54193;4287
Syddanmark;6-11-2020;F;66;0;2;781;54259;4289
Hovedstaden;6-11-2020;M;254;2;13;783;54513;4302
Midtjylland;6-11-2020;M;85;0;8;783;54598;4310
Nordjylland;6-11-2020;M;31;0;0;783;54629;4310
Sjælland;6-11-2020;M;73;0;3;783;54702;4313
Syddanmark;6-11-2020;M;64;0;2;783;54766;4315
Hovedstaden;7-11-2020;F;194;0;0;783;54960;4315
Midtjylland;7-11-2020;F;89;0;1;783;55049;4316
Nordjylland;7-11-2020;F;29;0;2;783;55078;4318
Sjælland;7-11-2020;F;58;0;2;783;55136;4320
Syddanmark;7-11-2020;F;55;0;0;783;55191;4320
Hovedstaden;7-11-2020;M;191;0;5;783;55382;4325
Midtjylland;7-11-2020;M;85;0;3;783;55467;4328
Nordjylland;7-11-2020;M;39;0;0;783;55506;4328
Sjælland;7-11-2020;M;57;2;3;785;55563;4331
Syddanmark;7-11-2020;M;47;0;2;785;55610;4333
Hovedstaden;8-11-2020;F;159;1;6;786;55769;4339
Midtjylland;8-11-2020;F;75;0;2;786;55844;4341
Nordjylland;8-11-2020;F;20;1;1;787;55864;4342
Sjælland;8-11-2020;F;41;0;1;787;55905;4343
Syddanmark;8-11-2020;F;49;0;2;787;55954;4345
Hovedstaden;8-11-2020;M;193;0;9;787;56147;4354
Midtjylland;8-11-2020;M;79;1;3;788;56226;4357
Nordjylland;8-11-2020;M;21;0;0;788;56247;4357
Sjælland;8-11-2020;M;49;0;4;788;56296;4361
Syddanmark;8-11-2020;M;51;0;1;788;56347;4362
Hovedstaden;9-11-2020;F;229;0;13;788;56576;4375
Midtjylland;9-11-2020;F;90;2;6;790;56666;4381
Nordjylland;9-11-2020;F;40;0;1;790;56706;4382
Sjælland;9-11-2020;F;69;0;3;790;56775;4385
Syddanmark;9-11-2020;F;76;0;2;790;56851;4387
Hovedstaden;9-11-2020;M;255;3;12;793;57106;4399
Midtjylland;9-11-2020;M;114;3;5;796;57220;4404
Nordjylland;9-11-2020;M;32;0;4;796;57252;4408
Sjælland;9-11-2020;M;49;0;3;796;57301;4411
Syddanmark;9-11-2020;M;89;0;5;796;57390;4416
Hovedstaden;10-11-2020;F;275;0;11;796;57665;4427
Midtjylland;10-11-2020;F;122;1;7;797;57787;4434
Nordjylland;10-11-2020;F;30;0;2;797;57817;4436
Sjælland;10-11-2020;F;81;0;6;797;57898;4442
Syddanmark;10-11-2020;F;72;0;2;797;57970;4444
Hovedstaden;10-11-2020;M;219;0;6;797;58189;4450
Midtjylland;10-11-2020;M;103;0;1;797;58292;4451
Nordjylland;10-11-2020;M;31;0;0;797;58323;4451
Sjælland;10-11-2020;M;66;0;4;797;58389;4455
Syddanmark;10-11-2020;M;54;0;1;797;58443;4456
Hovedstaden;11-11-2020;F;218;1;7;798;58661;4463
Midtjylland;11-11-2020;F;131;0;2;798;58792;4465
Nordjylland;11-11-2020;F;27;0;1;798;58819;4466
Sjælland;11-11-2020;F;67;0;1;798;58886;4467
Syddanmark;11-11-2020;F;71;0;1;798;58957;4468
Hovedstaden;11-11-2020;M;223;2;9;800;59180;4477
Midtjylland;11-11-2020;M;132;2;9;802;59312;4486
Nordjylland;11-11-2020;M;43;0;1;802;59355;4487
Sjælland;11-11-2020;M;85;0;4;802;59440;4491
Syddanmark;11-11-2020;M;91;1;6;803;59531;4497
Hovedstaden;12-11-2020;F;237;3;10;806;59768;4507
Midtjylland;12-11-2020;F;126;1;6;807;59894;4513
Nordjylland;12-11-2020;F;28;1;0;808;59922;4513
Sjælland;12-11-2020;F;45;0;2;808;59967;4515
Syddanmark;12-11-2020;F;70;0;0;808;60037;4515
Hovedstaden;12-11-2020;M;238;2;10;810;60275;4525
Midtjylland;12-11-2020;M;122;2;4;812;60397;4529
Nordjylland;12-11-2020;M;39;0;1;812;60436;4530
Sjælland;12-11-2020;M;73;0;0;812;60509;4530
Syddanmark;12-11-2020;M;74;0;2;812;60583;4532
Hovedstaden;13-11-2020;F;262;3;13;815;60845;4545
Midtjylland;13-11-2020;F;109;0;5;815;60954;4550
Nordjylland;13-11-2020;F;35;0;2;815;60989;4552
Sjælland;13-11-2020;F;68;0;4;815;61057;4556
Syddanmark;13-11-2020;F;69;0;4;815;61126;4560
Hovedstaden;13-11-2020;M;257;1;6;816;61383;4566
Midtjylland;13-11-2020;M;124;1;8;817;61507;4574
Nordjylland;13-11-2020;M;42;0;0;817;61549;4574
Sjælland;13-11-2020;M;83;0;6;817;61632;4580
Syddanmark;13-11-2020;M;99;0;0;817;61731;4580
Hovedstaden;14-11-2020;F;237;0;11;817;61968;4591
Midtjylland;14-11-2020;F;99;2;3;819;62067;4594
Nordjylland;14-11-2020;F;31;0;0;819;62098;4594
Sjælland;14-11-2020;F;59;0;3;819;62157;4597
Syddanmark;14-11-2020;F;85;0;2;819;62242;4599
Hovedstaden;14-11-2020;M;232;0;7;819;62474;4606
Midtjylland;14-11-2020;M;125;0;4;819;62599;4610
Nordjylland;14-11-2020;M;34;0;3;819;62633;4613
Sjælland;14-11-2020;M;44;0;2;819;62677;4615
Syddanmark;14-11-2020;M;97;1;3;820;62774;4618
Hovedstaden;15-11-2020;F;222;1;8;821;62996;4626
Midtjylland;15-11-2020;F;92;0;2;821;63088;4628
Nordjylland;15-11-2020;F;29;0;1;821;63117;4629
Sjælland;15-11-2020;F;50;0;1;821;63167;4630
Syddanmark;15-11-2020;F;80;0;3;821;63247;4633
Hovedstaden;15-11-2020;M;230;0;5;821;63477;4638
Midtjylland;15-11-2020;M;112;0;2;821;63589;4640
Nordjylland;15-11-2020;M;44;0;0;821;63633;4640
Sjælland;15-11-2020;M;60;0;2;821;63693;4642
Syddanmark;15-11-2020;M;70;1;3;822;63763;4645
Hovedstaden;16-11-2020;F;261;0;6;822;64024;4651
Midtjylland;16-11-2020;F;146;0;3;822;64170;4654
Nordjylland;16-11-2020;F;27;0;0;822;64197;4654
Sjælland;16-11-2020;F;59;0;1;822;64256;4655
Syddanmark;16-11-2020;F;107;0;2;822;64363;4657
Hovedstaden;16-11-2020;M;289;2;13;824;64652;4670
Midtjylland;16-11-2020;M;155;1;9;825;64807;4679
Nordjylland;16-11-2020;M;31;1;4;826;64838;4683
Sjælland;16-11-2020;M;84;0;5;826;64922;4688
Syddanmark;16-11-2020;M;92;0;2;826;65014;4690
Hovedstaden;17-11-2020;F;276;0;17;826;65290;4707
Midtjylland;17-11-2020;F;148;0;4;826;65438;4711
Nordjylland;17-11-2020;F;34;0;1;826;65472;4712
Sjælland;17-11-2020;F;68;0;1;826;65540;4713
Syddanmark;17-11-2020;F;112;0;2;826;65652;4715
Hovedstaden;17-11-2020;M;312;1;10;827;65964;4725
Midtjylland;17-11-2020;M;152;0;7;827;66116;4732
Nordjylland;17-11-2020;M;31;1;2;828;66147;4734
Sjælland;17-11-2020;M;69;1;3;829;66216;4737
Syddanmark;17-11-2020;M;126;0;4;829;66342;4741
Hovedstaden;18-11-2020;F;286;0;8;829;66628;4749
Midtjylland;18-11-2020;F;157;1;8;830;66785;4757
Nordjylland;18-11-2020;F;25;0;0;830;66810;4757
Sjælland;18-11-2020;F;66;0;1;830;66876;4758
Syddanmark;18-11-2020;F;104;0;1;830;66980;4759
Hovedstaden;18-11-2020;M;305;4;11;834;67285;4770
Midtjylland;18-11-2020;M;141;0;5;834;67426;4775
Nordjylland;18-11-2020;M;28;0;1;834;67454;4776
Sjælland;18-11-2020;M;81;0;6;834;67535;4782
Syddanmark;18-11-2020;M;137;0;7;834;67672;4789
Hovedstaden;19-11-2020;F;282;4;9;838;67954;4798
Midtjylland;19-11-2020;F;131;5;5;843;68085;4803
Nordjylland;19-11-2020;F;25;0;3;843;68110;4806
Sjælland;19-11-2020;F;59;0;3;843;68169;4809
Syddanmark;19-11-2020;F;101;0;2;843;68270;4811
Hovedstaden;19-11-2020;M;291;0;7;843;68561;4818
Midtjylland;19-11-2020;M;110;2;5;845;68671;4823
Nordjylland;19-11-2020;M;19;0;2;845;68690;4825
Sjælland;19-11-2020;M;81;0;5;845;68771;4830
Syddanmark;19-11-2020;M;122;1;4;846;68893;4834
Hovedstaden;20-11-2020;F;285;6;10;852;69178;4844
Midtjylland;20-11-2020;F;112;5;5;857;69290;4849
Nordjylland;20-11-2020;F;32;1;4;858;69322;4853
Sjælland;20-11-2020;F;77;0;4;858;69399;4857
Syddanmark;20-11-2020;F;109;0;2;858;69508;4859
Hovedstaden;20-11-2020;M;265;0;5;858;69773;4864
Midtjylland;20-11-2020;M;105;3;5;861;69878;4869
Nordjylland;20-11-2020;M;32;1;2;862;69910;4871
Sjælland;20-11-2020;M;79;1;3;863;69989;4874
Syddanmark;20-11-2020;M;126;1;3;864;70115;4877
Hovedstaden;21-11-2020;F;234;0;10;864;70349;4887
Midtjylland;21-11-2020;F;80;0;1;864;70429;4888
Nordjylland;21-11-2020;F;17;0;2;864;70446;4890
Sjælland;21-11-2020;F;56;0;2;864;70502;4892
Syddanmark;21-11-2020;F;68;1;3;865;70570;4895
Hovedstaden;21-11-2020;M;280;2;10;867;70850;4905
Midtjylland;21-11-2020;M;99;0;4;867;70949;4909
Nordjylland;21-11-2020;M;19;0;3;867;70968;4912
Sjælland;21-11-2020;M;55;1;0;868;71023;4912
Syddanmark;21-11-2020;M;93;0;1;868;71116;4913
Hovedstaden;22-11-2020;F;261;1;8;869;71377;4921
Midtjylland;22-11-2020;F;99;0;2;869;71476;4923
Nordjylland;22-11-2020;F;23;0;2;869;71499;4925
Sjælland;22-11-2020;F;39;1;2;870;71538;4927
Syddanmark;22-11-2020;F;76;0;1;870;71614;4928
Hovedstaden;22-11-2020;M;254;4;16;874;71868;4944
Midtjylland;22-11-2020;M;93;0;2;874;71961;4946
Nordjylland;22-11-2020;M;15;0;1;874;71976;4947
Sjælland;22-11-2020;M;56;0;3;874;72032;4950
Syddanmark;22-11-2020;M;93;0;2;874;72125;4952
Hovedstaden;23-11-2020;F;291;3;14;877;72416;4966
Midtjylland;23-11-2020;F;97;0;2;877;72513;4968
Nordjylland;23-11-2020;F;20;0;1;877;72533;4969
Sjælland;23-11-2020;F;75;1;3;878;72608;4972
Syddanmark;23-11-2020;F;115;1;8;879;72723;4980
Hovedstaden;23-11-2020;M;300;3;14;882;73023;4994
Midtjylland;23-11-2020;M;94;2;6;884;73117;5000
Nordjylland;23-11-2020;M;15;0;0;884;73132;5000
Sjælland;23-11-2020;M;68;0;3;884;73200;5003
Syddanmark;23-11-2020;M;112;0;2;884;73312;5005
Hovedstaden;24-11-2020;F;336;3;6;887;73648;5011
Midtjylland;24-11-2020;F;122;1;2;888;73770;5013
Nordjylland;24-11-2020;F;21;0;0;888;73791;5013
Sjælland;24-11-2020;F;76;0;2;888;73867;5015
Syddanmark;24-11-2020;F;96;0;0;888;73963;5015
Hovedstaden;24-11-2020;M;337;1;19;889;74300;5034
Midtjylland;24-11-2020;M;115;1;9;890;74415;5043
Nordjylland;24-11-2020;M;21;0;0;890;74436;5043
Sjælland;24-11-2020;M;74;0;5;890;74510;5048
Syddanmark;24-11-2020;M;128;0;6;890;74638;5054
Hovedstaden;25-11-2020;F;333;1;6;891;74971;5060
Midtjylland;25-11-2020;F;99;0;5;891;75070;5065
Nordjylland;25-11-2020;F;26;0;1;891;75096;5066
Sjælland;25-11-2020;F;81;0;2;891;75177;5068
Syddanmark;25-11-2020;F;89;0;2;891;75266;5070
Hovedstaden;25-11-2020;M;335;0;6;891;75601;5076
Midtjylland;25-11-2020;M;134;2;9;893;75735;5085
Nordjylland;25-11-2020;M;20;1;2;894;75755;5087
Sjælland;25-11-2020;M;89;3;7;897;75844;5094
Syddanmark;25-11-2020;M;107;1;8;898;75951;5102
Hovedstaden;26-11-2020;F;319;0;5;898;76270;5107
Midtjylland;26-11-2020;F;117;2;5;900;76387;5112
Nordjylland;26-11-2020;F;25;0;1;900;76412;5113
Sjælland;26-11-2020;F;93;0;3;900;76505;5116
Syddanmark;26-11-2020;F;99;0;3;900;76604;5119
Hovedstaden;26-11-2020;M;301;5;14;905;76905;5133
Midtjylland;26-11-2020;M;129;0;2;905;77034;5135
Nordjylland;26-11-2020;M;20;0;0;905;77054;5135
Sjælland;26-11-2020;M;71;1;5;906;77125;5140
Syddanmark;26-11-2020;M;82;0;2;906;77207;5142
Hovedstaden;27-11-2020;F;344;7;21;913;77551;5163
Midtjylland;27-11-2020;F;115;1;6;914;77666;5169
Nordjylland;27-11-2020;F;16;0;2;914;77682;5171
Sjælland;27-11-2020;F;60;0;1;914;77742;5172
Syddanmark;27-11-2020;F;111;1;4;915;77853;5176
Hovedstaden;27-11-2020;M;349;0;14;915;78202;5190
Midtjylland;27-11-2020;M;116;3;6;918;78318;5196
Nordjylland;27-11-2020;M;22;0;0;918;78340;5196
Sjælland;27-11-2020;M;73;0;4;918;78413;5200
Syddanmark;27-11-2020;M;102;0;3;918;78515;5203
Hovedstaden;28-11-2020;F;313;0;6;918;78828;5209
Midtjylland;28-11-2020;F;98;0;1;918;78926;5210
Nordjylland;28-11-2020;F;13;0;1;918;78939;5211
Sjælland;28-11-2020;F;67;0;1;918;79006;5212
Syddanmark;28-11-2020;F;66;0;1;918;79072;5213
Hovedstaden;28-11-2020;M;315;1;12;919;79387;5225
Midtjylland;28-11-2020;M;114;1;5;920;79501;5230
Nordjylland;28-11-2020;M;13;0;1;920;79514;5231
Sjælland;28-11-2020;M;79;0;3;920;79593;5234
Syddanmark;28-11-2020;M;73;1;3;921;79666;5237
Hovedstaden;29-11-2020;F;326;0;7;921;79992;5244
Midtjylland;29-11-2020;F;76;0;3;921;80068;5247
Nordjylland;29-11-2020;F;12;0;0;921;80080;5247
Sjælland;29-11-2020;F;63;3;4;924;80143;5251
Syddanmark;29-11-2020;F;70;0;1;924;80213;5252
Hovedstaden;29-11-2020;M;348;3;5;927;80561;5257
Midtjylland;29-11-2020;M;109;1;4;928;80670;5261
Nordjylland;29-11-2020;M;25;0;1;928;80695;5262
Sjælland;29-11-2020;M;80;1;2;929;80775;5264
Syddanmark;29-11-2020;M;64;0;1;929;80839;5265
Hovedstaden;30-11-2020;F;408;5;21;934;81247;5286
Midtjylland;30-11-2020;F;160;2;6;936;81407;5292
Nordjylland;30-11-2020;F;24;0;0;936;81431;5292
Sjælland;30-11-2020;F;110;0;4;936;81541;5296
Syddanmark;30-11-2020;F;94;0;3;936;81635;5299
Hovedstaden;30-11-2020;M;353;4;9;940;81988;5308
Midtjylland;30-11-2020;M;166;3;5;943;82154;5313
Nordjylland;30-11-2020;M;15;0;0;943;82169;5313
Sjælland;30-11-2020;M;96;0;3;943;82265;5316
Syddanmark;30-11-2020;M;105;0;5;943;82370;5321
Hovedstaden;1-12-2020;F;499;2;18;945;82869;5339
Midtjylland;1-12-2020;F;148;1;8;946;83017;5347
Nordjylland;1-12-2020;F;29;0;1;946;83046;5348
Sjælland;1-12-2020;F;101;0;3;946;83147;5351
Syddanmark;1-12-2020;F;93;0;3;946;83240;5354
Hovedstaden;1-12-2020;M;459;1;8;947;83699;5362
Midtjylland;1-12-2020;M;144;1;7;948;83843;5369
Nordjylland;1-12-2020;M;18;0;1;948;83861;5370
Sjælland;1-12-2020;M;106;1;6;949;83967;5376
Syddanmark;1-12-2020;M;115;0;4;949;84082;5380
Hovedstaden;2-12-2020;F;502;1;16;950;84584;5396
Midtjylland;2-12-2020;F;171;0;7;950;84755;5403
Nordjylland;2-12-2020;F;30;0;0;950;84785;5403
Sjælland;2-12-2020;F;146;0;3;950;84931;5406
Syddanmark;2-12-2020;F;85;2;5;952;85016;5411
Hovedstaden;2-12-2020;M;524;2;20;954;85540;5431
Midtjylland;2-12-2020;M;155;0;11;954;85695;5442
Nordjylland;2-12-2020;M;30;0;0;954;85725;5442
Sjælland;2-12-2020;M;122;1;4;955;85847;5446
Syddanmark;2-12-2020;M;111;1;2;956;85958;5448
Hovedstaden;3-12-2020;F;536;2;20;958;86494;5468
Midtjylland;3-12-2020;F;155;0;6;958;86649;5474
Nordjylland;3-12-2020;F;23;0;0;958;86672;5474
Sjælland;3-12-2020;F;126;1;6;959;86798;5480
Syddanmark;3-12-2020;F;131;0;4;959;86929;5484
Hovedstaden;3-12-2020;M;488;2;14;961;87417;5498
Midtjylland;3-12-2020;M;177;3;8;964;87594;5506
Nordjylland;3-12-2020;M;30;0;0;964;87624;5506
Sjælland;3-12-2020;M;123;0;6;964;87747;5512
Syddanmark;3-12-2020;M;117;0;3;964;87864;5515
Hovedstaden;4-12-2020;F;528;2;23;966;88392;5538
Midtjylland;4-12-2020;F;208;1;5;967;88600;5543
Nordjylland;4-12-2020;F;26;0;1;967;88626;5544
Sjælland;4-12-2020;F;139;0;2;967;88765;5546
Syddanmark;4-12-2020;F;106;0;2;967;88871;5548
Hovedstaden;4-12-2020;M;530;4;21;971;89401;5569
Midtjylland;4-12-2020;M;194;1;8;972;89595;5577
Nordjylland;4-12-2020;M;39;0;0;972;89634;5577
Sjælland;4-12-2020;M;125;0;5;972;89759;5582
Syddanmark;4-12-2020;M;122;0;1;972;89881;5583
Hovedstaden;5-12-2020;F;483;6;21;978;90364;5604
Midtjylland;5-12-2020;F;138;3;5;981;90502;5609
Nordjylland;5-12-2020;F;25;0;0;981;90527;5609
Sjælland;5-12-2020;F;150;2;7;983;90677;5616
Syddanmark;5-12-2020;F;75;1;2;984;90752;5618
Hovedstaden;5-12-2020;M;491;5;20;989;91243;5638
Midtjylland;5-12-2020;M;128;0;7;989;91371;5645
Nordjylland;5-12-2020;M;28;1;3;990;91399;5648
Sjælland;5-12-2020;M;117;1;7;991;91516;5655
Syddanmark;5-12-2020;M;80;0;4;991;91596;5659
Hovedstaden;6-12-2020;F;600;2;19;993;92196;5678
Midtjylland;6-12-2020;F;163;0;5;993;92359;5683
Nordjylland;6-12-2020;F;42;1;1;994;92401;5684
Sjælland;6-12-2020;F;136;0;5;994;92537;5689
Syddanmark;6-12-2020;F;90;0;1;994;92627;5690
Hovedstaden;6-12-2020;M;513;5;28;999;93140;5718
Midtjylland;6-12-2020;M;142;0;3;999;93282;5721
Nordjylland;6-12-2020;M;28;0;0;999;93310;5721
Sjælland;6-12-2020;M;138;1;9;1000;93448;5730
Syddanmark;6-12-2020;M;124;1;4;1001;93572;5734
Hovedstaden;7-12-2020;F;760;11;36;1012;94332;5770
Midtjylland;7-12-2020;F;228;1;5;1013;94560;5775
Nordjylland;7-12-2020;F;47;0;1;1013;94607;5776
Sjælland;7-12-2020;F;198;0;9;1013;94805;5785
Syddanmark;7-12-2020;F;159;0;4;1013;94964;5789
Hovedstaden;7-12-2020;M;753;8;35;1021;95717;5824
Midtjylland;7-12-2020;M;213;0;5;1021;95930;5829
Nordjylland;7-12-2020;M;58;1;2;1022;95988;5831
Sjælland;7-12-2020;M;184;0;8;1022;96172;5839
Syddanmark;7-12-2020;M;150;1;8;1023;96322;5847
Hovedstaden;8-12-2020;F;862;5;24;1028;97184;5871
Midtjylland;8-12-2020;F;265;0;8;1028;97449;5879
Nordjylland;8-12-2020;F;78;0;3;1028;97527;5882
Sjælland;8-12-2020;F;232;1;9;1029;97759;5891
Syddanmark;8-12-2020;F;156;1;7;1030;97915;5898
Hovedstaden;8-12-2020;M;807;7;31;1037;98722;5929
Midtjylland;8-12-2020;M;254;1;6;1038;98976;5935
Nordjylland;8-12-2020;M;61;0;3;1038;99037;5938
Sjælland;8-12-2020;M;234;1;4;1039;99271;5942
Syddanmark;8-12-2020;M;174;0;2;1039;99445;5944
Hovedstaden;9-12-2020;F;838;2;29;1041;100283;5973
Midtjylland;9-12-2020;F;304;3;4;1044;100587;5977
Nordjylland;9-12-2020;F;66;0;0;1044;100653;5977
Sjælland;9-12-2020;F;228;1;13;1045;100881;5990
Syddanmark;9-12-2020;F;172;0;2;1045;101053;5992
Hovedstaden;9-12-2020;M;857;4;23;1049;101910;6015
Midtjylland;9-12-2020;M;274;1;8;1050;102184;6023
Nordjylland;9-12-2020;M;79;0;1;1050;102263;6024
Sjælland;9-12-2020;M;210;2;9;1052;102473;6033
Syddanmark;9-12-2020;M;160;0;2;1052;102633;6035
Hovedstaden;10-12-2020;F;944;9;32;1061;103577;6067
Midtjylland;10-12-2020;F;321;1;7;1062;103898;6074
Nordjylland;10-12-2020;F;78;0;4;1062;103976;6078
Sjælland;10-12-2020;F;243;1;5;1063;104219;6083
Syddanmark;10-12-2020;F;147;2;5;1065;104366;6088
Hovedstaden;10-12-2020;M;862;8;33;1073;105228;6121
Midtjylland;10-12-2020;M;278;2;4;1075;105506;6125
Nordjylland;10-12-2020;M;88;1;1;1076;105594;6126
Sjælland;10-12-2020;M;184;1;12;1077;105778;6138
Syddanmark;10-12-2020;M;135;0;4;1077;105913;6142
Hovedstaden;11-12-2020;F;840;7;36;1084;106753;6178
Midtjylland;11-12-2020;F;304;0;11;1084;107057;6189
Nordjylland;11-12-2020;F;58;1;0;1085;107115;6189
Sjælland;11-12-2020;F;253;2;10;1087;107368;6199
Syddanmark;11-12-2020;F;166;1;6;1088;107534;6205
Hovedstaden;11-12-2020;M;899;6;43;1094;108433;6248
Midtjylland;11-12-2020;M;279;0;14;1094;108712;6262
Nordjylland;11-12-2020;M;67;0;1;1094;108779;6263
Sjælland;11-12-2020;M;252;1;9;1095;109031;6272
Syddanmark;11-12-2020;M;176;0;5;1095;109207;6277
Hovedstaden;12-12-2020;F;856;3;40;1098;110063;6317
Midtjylland;12-12-2020;F;267;0;4;1098;110330;6321
Nordjylland;12-12-2020;F;76;0;3;1098;110406;6324
Sjælland;12-12-2020;F;226;0;1;1098;110632;6325
Syddanmark;12-12-2020;F;150;0;4;1098;110782;6329
Hovedstaden;12-12-2020;M;828;3;17;1101;111610;6346
Midtjylland;12-12-2020;M;277;1;8;1102;111887;6354
Nordjylland;12-12-2020;M;84;1;4;1103;111971;6358
Sjælland;12-12-2020;M;187;0;8;1103;112158;6366
Syddanmark;12-12-2020;M;137;0;3;1103;112295;6369
Hovedstaden;13-12-2020;F;967;8;43;1111;113262;6412
Midtjylland;13-12-2020;F;245;2;6;1113;113507;6418
Nordjylland;13-12-2020;F;61;0;5;1113;113568;6423
Sjælland;13-12-2020;F;207;0;6;1113;113775;6429
Syddanmark;13-12-2020;F;152;0;1;1113;113927;6430
Hovedstaden;13-12-2020;M;925;7;37;1120;114852;6467
Midtjylland;13-12-2020;M;231;1;9;1121;115083;6476
Nordjylland;13-12-2020;M;62;2;6;1123;115145;6482
Sjælland;13-12-2020;M;169;0;15;1123;115314;6497
Syddanmark;13-12-2020;M;147;1;7;1124;115461;6504
Hovedstaden;14-12-2020;F;1033;7;37;1131;116494;6541
Midtjylland;14-12-2020;F;381;1;10;1132;116875;6551
Nordjylland;14-12-2020;F;94;1;3;1133;116969;6554
Sjælland;14-12-2020;F;321;4;15;1137;117290;6569
Syddanmark;14-12-2020;F;207;0;8;1137;117497;6577
Hovedstaden;14-12-2020;M;980;12;45;1149;118477;6622
Midtjylland;14-12-2020;M;384;1;9;1150;118861;6631
Nordjylland;14-12-2020;M;99;0;5;1150;118960;6636
Sjælland;14-12-2020;M;271;4;15;1154;119231;6651
Syddanmark;14-12-2020;M;215;2;3;1156;119446;6654
Hovedstaden;15-12-2020;F;1112;5;42;1161;120558;6696
Midtjylland;15-12-2020;F;420;2;9;1163;120978;6705
Nordjylland;15-12-2020;F;97;0;2;1163;121075;6707
Sjælland;15-12-2020;F;323;4;13;1167;121398;6720
Syddanmark;15-12-2020;F;267;1;4;1168;121665;6724
Hovedstaden;15-12-2020;M;1012;2;29;1170;122677;6753
Midtjylland;15-12-2020;M;384;4;14;1174;123061;6767
Nordjylland;15-12-2020;M;113;1;1;1175;123174;6768
Sjælland;15-12-2020;M;287;4;19;1179;123461;6787
Syddanmark;15-12-2020;M;275;1;10;1180;123736;6797
Hovedstaden;16-12-2020;F;1187;5;59;1185;124923;6856
Midtjylland;16-12-2020;F;367;0;10;1185;125290;6866
Nordjylland;16-12-2020;F;113;1;2;1186;125403;6868
Sjælland;16-12-2020;F;378;2;15;1188;125781;6883
Syddanmark;16-12-2020;F;258;1;8;1189;126039;6891
Hovedstaden;16-12-2020;M;1020;5;44;1194;127059;6935
Midtjylland;16-12-2020;M;380;2;16;1196;127439;6951
Nordjylland;16-12-2020;M;113;1;7;1197;127552;6958
Sjælland;16-12-2020;M;307;1;18;1198;127859;6976
Syddanmark;16-12-2020;M;264;1;5;1199;128123;6981
Hovedstaden;17-12-2020;F;917;7;41;1206;129040;7022
Midtjylland;17-12-2020;F;312;1;10;1207;129352;7032
Nordjylland;17-12-2020;F;102;0;1;1207;129454;7033
Sjælland;17-12-2020;F;317;3;13;1210;129771;7046
Syddanmark;17-12-2020;F;257;1;6;1211;130028;7052
Hovedstaden;17-12-2020;M;820;10;60;1221;130848;7112
Midtjylland;17-12-2020;M;296;1;13;1222;131144;7125
Nordjylland;17-12-2020;M;100;0;2;1222;131244;7127
Sjælland;17-12-2020;M;253;3;10;1225;131497;7137
Syddanmark;17-12-2020;M;237;0;10;1225;131734;7147
Hovedstaden;18-12-2020;F;763;7;42;1232;132497;7189
Midtjylland;18-12-2020;F;293;0;5;1232;132790;7194
Nordjylland;18-12-2020;F;101;0;1;1232;132891;7195
Sjælland;18-12-2020;F;247;4;11;1236;133138;7206
Syddanmark;18-12-2020;F;183;3;11;1239;133321;7217
Hovedstaden;18-12-2020;M;756;10;39;1249;134077;7256
Midtjylland;18-12-2020;M;255;5;14;1254;134332;7270
Nordjylland;18-12-2020;M;112;0;3;1254;134444;7273
Sjælland;18-12-2020;M;228;5;18;1259;134672;7291
Syddanmark;18-12-2020;M;192;1;5;1260;134864;7296
Hovedstaden;19-12-2020;F;666;7;41;1267;135530;7337
Midtjylland;19-12-2020;F;252;2;11;1269;135782;7348
Nordjylland;19-12-2020;F;113;2;7;1271;135895;7355
Sjælland;19-12-2020;F;181;3;5;1274;136076;7360
Syddanmark;19-12-2020;F;202;1;7;1275;136278;7367
Hovedstaden;19-12-2020;M;610;10;31;1285;136888;7398
Midtjylland;19-12-2020;M;262;3;9;1288;137150;7407
Nordjylland;19-12-2020;M;98;0;4;1288;137248;7411
Sjælland;19-12-2020;M;207;4;14;1292;137455;7425
Syddanmark;19-12-2020;M;163;3;9;1295;137618;7434
Hovedstaden;20-12-2020;F;607;3;27;1298;138225;7461
Midtjylland;20-12-2020;F;205;0;5;1298;138430;7466
Nordjylland;20-12-2020;F;89;0;1;1298;138519;7467
Sjælland;20-12-2020;F;216;6;13;1304;138735;7480
Syddanmark;20-12-2020;F;156;1;6;1305;138891;7486
Hovedstaden;20-12-2020;M;566;8;49;1313;139457;7535
Midtjylland;20-12-2020;M;185;3;9;1316;139642;7544
Nordjylland;20-12-2020;M;80;1;2;1317;139722;7546
Sjælland;20-12-2020;M;183;1;8;1318;139905;7554
Syddanmark;20-12-2020;M;166;5;7;1323;140071;7561
Hovedstaden;21-12-2020;F;815;9;43;1332;140886;7604
Midtjylland;21-12-2020;F;311;1;10;1333;141197;7614
Nordjylland;21-12-2020;F;103;1;3;1334;141300;7617
Sjælland;21-12-2020;F;283;3;15;1337;141583;7632
Syddanmark;21-12-2020;F;238;0;10;1337;141821;7642
Hovedstaden;21-12-2020;M;634;12;42;1349;142455;7684
Midtjylland;21-12-2020;M;202;5;15;1354;142657;7699
Nordjylland;21-12-2020;M;94;1;7;1355;142751;7706
Sjælland;21-12-2020;M;206;0;12;1355;142957;7718
Syddanmark;21-12-2020;M;213;1;10;1356;143170;7728
Hovedstaden;22-12-2020;F;710;7;38;1363;143880;7766
Midtjylland;22-12-2020;F;256;3;13;1366;144136;7779
Nordjylland;22-12-2020;F;128;1;4;1367;144264;7783
Sjælland;22-12-2020;F;256;2;14;1369;144520;7797
Syddanmark;22-12-2020;F;194;3;8;1372;144714;7805
Hovedstaden;22-12-2020;M;632;10;48;1382;145346;7853
Midtjylland;22-12-2020;M;214;6;10;1388;145560;7863
Nordjylland;22-12-2020;M;114;5;8;1393;145674;7871
Sjælland;22-12-2020;M;203;4;14;1397;145877;7885
Syddanmark;22-12-2020;M;161;1;8;1398;146038;7893
Hovedstaden;23-12-2020;F;765;7;32;1405;146803;7925
Midtjylland;23-12-2020;F;268;1;13;1406;147071;7938
Nordjylland;23-12-2020;F;121;1;7;1407;147192;7945
Sjælland;23-12-2020;F;228;3;20;1410;147420;7965
Syddanmark;23-12-2020;F;199;1;7;1411;147619;7972
Hovedstaden;23-12-2020;M;661;8;36;1419;148280;8008
Midtjylland;23-12-2020;M;247;2;12;1421;148527;8020
Nordjylland;23-12-2020;M;134;3;4;1424;148661;8024
Sjælland;23-12-2020;M;214;3;17;1427;148875;8041
Syddanmark;23-12-2020;M;238;0;8;1427;149113;8049
Hovedstaden;24-12-2020;F;370;7;22;1434;149483;8071
Midtjylland;24-12-2020;F;131;1;11;1435;149614;8082
Nordjylland;24-12-2020;F;65;0;4;1435;149679;8086
Sjælland;24-12-2020;F;79;3;4;1438;149758;8090
Syddanmark;24-12-2020;F;111;0;2;1438;149869;8092
Hovedstaden;24-12-2020;M;358;5;32;1443;150227;8124
Midtjylland;24-12-2020;M;115;1;8;1444;150342;8132
Nordjylland;24-12-2020;M;69;0;4;1444;150411;8136
Sjælland;24-12-2020;M;77;3;6;1447;150488;8142
Syddanmark;24-12-2020;M;97;0;2;1447;150585;8144
Hovedstaden;25-12-2020;F;429;9;41;1456;151014;8185
Midtjylland;25-12-2020;F;112;1;4;1457;151126;8189
Nordjylland;25-12-2020;F;65;1;3;1458;151191;8192
Sjælland;25-12-2020;F;122;2;12;1460;151313;8204
Syddanmark;25-12-2020;F;129;0;6;1460;151442;8210
Hovedstaden;25-12-2020;M;376;12;37;1472;151818;8247
Midtjylland;25-12-2020;M;102;3;11;1475;151920;8258
Nordjylland;25-12-2020;M;65;3;3;1478;151985;8261
Sjælland;25-12-2020;M;83;2;10;1480;152068;8271
Syddanmark;25-12-2020;M;103;1;7;1481;152171;8278
Hovedstaden;26-12-2020;F;674;11;35;1492;152845;8313
Midtjylland;26-12-2020;F;228;1;8;1493;153073;8321
Nordjylland;26-12-2020;F;91;0;4;1493;153164;8325
Sjælland;26-12-2020;F;228;1;7;1494;153392;8332
Syddanmark;26-12-2020;F;171;1;6;1495;153563;8338
Hovedstaden;26-12-2020;M;604;11;54;1506;154167;8392
Midtjylland;26-12-2020;M;232;3;12;1509;154399;8404
Nordjylland;26-12-2020;M;87;0;6;1509;154486;8410
Sjælland;26-12-2020;M;217;3;21;1512;154703;8431
Syddanmark;26-12-2020;M;152;2;10;1514;154855;8441
Hovedstaden;27-12-2020;F;545;11;39;1525;155400;8480
Midtjylland;27-12-2020;F;232;3;9;1528;155632;8489
Nordjylland;27-12-2020;F;100;2;6;1530;155732;8495
Sjælland;27-12-2020;F;161;0;2;1530;155893;8497
Syddanmark;27-12-2020;F;154;4;10;1534;156047;8507
Hovedstaden;27-12-2020;M;467;7;31;1541;156514;8538
Midtjylland;27-12-2020;M;184;5;9;1546;156698;8547
Nordjylland;27-12-2020;M;71;1;3;1547;156769;8550
Sjælland;27-12-2020;M;165;6;18;1553;156934;8568
Syddanmark;27-12-2020;M;105;0;9;1553;157039;8577
Hovedstaden;28-12-2020;F;754;15;52;1568;157793;8629
Midtjylland;28-12-2020;F;305;3;16;1571;158098;8645
Nordjylland;28-12-2020;F;138;1;6;1572;158236;8651
Sjælland;28-12-2020;F;295;4;15;1576;158531;8666
Syddanmark;28-12-2020;F;216;4;14;1580;158747;8680
Hovedstaden;28-12-2020;M;535;10;39;1590;159282;8719
Midtjylland;28-12-2020;M;263;5;25;1595;159545;8744
Nordjylland;28-12-2020;M;123;1;1;1596;159668;8745
Sjælland;28-12-2020;M;249;1;22;1597;159917;8767
Syddanmark;28-12-2020;M;184;4;16;1601;160101;8783
Hovedstaden;29-12-2020;F;563;11;48;1612;160664;8831
Midtjylland;29-12-2020;F;281;4;12;1616;160945;8843
Nordjylland;29-12-2020;F;98;3;6;1619;161043;8849
Sjælland;29-12-2020;F;260;1;12;1620;161303;8861
Syddanmark;29-12-2020;F;175;1;4;1621;161478;8865
Hovedstaden;29-12-2020;M;422;11;37;1632;161900;8902
Midtjylland;29-12-2020;M;239;1;16;1633;162139;8918
Nordjylland;29-12-2020;M;89;0;3;1633;162228;8921
Sjælland;29-12-2020;M;182;0;9;1633;162410;8930
Syddanmark;29-12-2020;M;166;2;8;1635;162576;8938
Hovedstaden;30-12-2020;F;616;10;36;1645;163192;8974
Midtjylland;30-12-2020;F;250;2;11;1647;163442;8985
Nordjylland;30-12-2020;F;120;0;5;1647;163562;8990
Sjælland;30-12-2020;F;264;5;12;1652;163826;9002
Syddanmark;30-12-2020;F;199;3;5;1655;164025;9007
Hovedstaden;30-12-2020;M;565;9;42;1664;164590;9049
Midtjylland;30-12-2020;M;230;4;19;1668;164820;9068
Nordjylland;30-12-2020;M;93;1;7;1669;164913;9075
Sjælland;30-12-2020;M;255;7;19;1676;165168;9094
Syddanmark;30-12-2020;M;176;1;4;1677;165344;9098
Hovedstaden;31-12-2020;F;284;6;22;1683;165628;9120
Midtjylland;31-12-2020;F;122;2;2;1685;165750;9122
Nordjylland;31-12-2020;F;62;1;4;1686;165812;9126
Sjælland;31-12-2020;F;85;0;4;1686;165897;9130
Syddanmark;31-12-2020;F;89;1;6;1687;165986;9136
Hovedstaden;31-12-2020;M;278;8;30;1695;166264;9166
Midtjylland;31-12-2020;M;119;0;9;1695;166383;9175
Nordjylland;31-12-2020;M;43;0;3;1695;166426;9178
Sjælland;31-12-2020;M;68;0;9;1695;166494;9187
Syddanmark;31-12-2020;M;77;1;5;1696;166571;9192
Hovedstaden;1-1-2021;F;288;6;22;1702;166859;9214
Midtjylland;1-1-2021;F;130;1;5;1703;166989;9219
Nordjylland;1-1-2021;F;51;0;2;1703;167040;9221
Sjælland;1-1-2021;F;69;1;9;1704;167109;9230
Syddanmark;1-1-2021;F;90;0;4;1704;167199;9234
Hovedstaden;1-1-2021;M;284;6;25;1710;167483;9259
Midtjylland;1-1-2021;M;101;1;6;1711;167584;9265
Nordjylland;1-1-2021;M;42;2;6;1713;167626;9271
Sjælland;1-1-2021;M;70;1;11;1714;167696;9282
Syddanmark;1-1-2021;M;77;2;6;1716;167773;9288
Hovedstaden;2-1-2021;F;435;3;32;1719;168208;9320
Midtjylland;2-1-2021;F;215;2;3;1721;168423;9323
Nordjylland;2-1-2021;F;95;0;2;1721;168518;9325
Sjælland;2-1-2021;F;162;0;12;1721;168680;9337
Syddanmark;2-1-2021;F;136;1;5;1722;168816;9342
Hovedstaden;2-1-2021;M;402;7;26;1729;169218;9368
Midtjylland;2-1-2021;M;221;2;15;1731;169439;9383
Nordjylland;2-1-2021;M;90;2;9;1733;169529;9392
Sjælland;2-1-2021;M;160;8;16;1741;169689;9408
Syddanmark;2-1-2021;M;124;2;9;1743;169813;9417
Hovedstaden;3-1-2021;F;392;2;21;1745;170205;9438
Midtjylland;3-1-2021;F;184;2;10;1747;170389;9448
Nordjylland;3-1-2021;F;110;7;8;1754;170499;9456
Sjælland;3-1-2021;F;114;2;8;1756;170613;9464
Syddanmark;3-1-2021;F;115;1;5;1757;170728;9469
Hovedstaden;3-1-2021;M;322;3;24;1760;171050;9493
Midtjylland;3-1-2021;M;146;0;6;1760;171196;9499
Nordjylland;3-1-2021;M;68;3;6;1763;171264;9505
Sjælland;3-1-2021;M;107;2;11;1765;171371;9516
Syddanmark;3-1-2021;M;111;0;9;1765;171482;9525
Hovedstaden;4-1-2021;F;580;16;31;1781;172062;9556
Midtjylland;4-1-2021;F;245;5;7;1786;172307;9563
Nordjylland;4-1-2021;F;108;2;6;1788;172415;9569
Sjælland;4-1-2021;F;220;1;8;1789;172635;9577
Syddanmark;4-1-2021;F;175;0;7;1789;172810;9584
Hovedstaden;4-1-2021;M;480;12;35;1801;173290;9619
Midtjylland;4-1-2021;M;213;3;11;1804;173503;9630
Nordjylland;4-1-2021;M;102;2;6;1806;173605;9636
Sjælland;4-1-2021;M;179;2;12;1808;173784;9648
Syddanmark;4-1-2021;M;174;1;6;1809;173958;9654
Hovedstaden;5-1-2021;F;447;0;24;1809;174405;9678
Midtjylland;5-1-2021;F;182;4;11;1813;174587;9689
Nordjylland;5-1-2021;F;85;2;4;1815;174672;9693
Sjælland;5-1-2021;F;205;3;10;1818;174877;9703
Syddanmark;5-1-2021;F;157;3;10;1821;175034;9713
Hovedstaden;5-1-2021;M;378;7;22;1828;175412;9735
Midtjylland;5-1-2021;M;133;0;11;1828;175545;9746
Nordjylland;5-1-2021;M;69;0;3;1828;175614;9749
Sjælland;5-1-2021;M;145;3;9;1831;175759;9758
Syddanmark;5-1-2021;M;122;1;11;1832;175881;9769
Hovedstaden;6-1-2021;F;401;9;31;1841;176282;9800
Midtjylland;6-1-2021;F;154;5;12;1846;176436;9812
Nordjylland;6-1-2021;F;89;0;3;1846;176525;9815
Sjælland;6-1-2021;F;143;3;17;1849;176668;9832
Syddanmark;6-1-2021;F;112;0;6;1849;176780;9838
Hovedstaden;6-1-2021;M;313;10;28;1859;177093;9866
Midtjylland;6-1-2021;M;125;3;10;1862;177218;9876
Nordjylland;6-1-2021;M;87;2;2;1864;177305;9878
Sjælland;6-1-2021;M;129;3;10;1867;177434;9888
Syddanmark;6-1-2021;M;101;0;2;1867;177535;9890
Hovedstaden;7-1-2021;F;318;6;18;1873;177853;9908
Midtjylland;7-1-2021;F;189;5;11;1878;178042;9919
Nordjylland;7-1-2021;F;70;1;4;1879;178112;9923
Sjælland;7-1-2021;F;152;3;15;1882;178264;9938
Syddanmark;7-1-2021;F;136;2;8;1884;178400;9946
Hovedstaden;7-1-2021;M;266;3;20;1887;178666;9966
Midtjylland;7-1-2021;M;147;8;16;1895;178813;9982
Nordjylland;7-1-2021;M;74;1;2;1896;178887;9984
Sjælland;7-1-2021;M;96;4;15;1900;178983;9999
Syddanmark;7-1-2021;M;136;3;9;1903;179119;10008
Hovedstaden;8-1-2021;F;338;5;26;1908;179457;10034
Midtjylland;8-1-2021;F;144;1;11;1909;179601;10045
Nordjylland;8-1-2021;F;57;1;2;1910;179658;10047
Sjælland;8-1-2021;F;107;1;5;1911;179765;10052
Syddanmark;8-1-2021;F;118;1;8;1912;179883;10060
Hovedstaden;8-1-2021;M;269;7;22;1919;180152;10082
Midtjylland;8-1-2021;M;109;3;10;1922;180261;10092
Nordjylland;8-1-2021;M;59;2;9;1924;180320;10101
Sjælland;8-1-2021;M;115;2;10;1926;180435;10111
Syddanmark;8-1-2021;M;110;1;6;1927;180545;10117
Hovedstaden;9-1-2021;F;255;3;20;1930;180800;10137
Midtjylland;9-1-2021;F;113;2;3;1932;180913;10140
Nordjylland;9-1-2021;F;51;0;2;1932;180964;10142
Sjælland;9-1-2021;F;113;3;12;1935;181077;10154
Syddanmark;9-1-2021;F;88;3;4;1938;181165;10158
Hovedstaden;9-1-2021;M;227;9;29;1947;181392;10187
Midtjylland;9-1-2021;M;109;3;6;1950;181501;10193
Nordjylland;9-1-2021;M;50;0;3;1950;181551;10196
Sjælland;9-1-2021;M;99;3;14;1953;181650;10210
Syddanmark;9-1-2021;M;86;3;6;1956;181736;10216
Hovedstaden;10-1-2021;F;210;2;17;1958;181946;10233
Midtjylland;10-1-2021;F;100;2;6;1960;182046;10239
Nordjylland;10-1-2021;F;45;0;3;1960;182091;10242
Sjælland;10-1-2021;F;86;3;13;1963;182177;10255
Syddanmark;10-1-2021;F;75;1;7;1964;182252;10262
Hovedstaden;10-1-2021;M;198;7;23;1971;182450;10285
Midtjylland;10-1-2021;M;85;1;7;1972;182535;10292
Nordjylland;10-1-2021;M;36;2;4;1974;182571;10296
Sjælland;10-1-2021;M;81;1;6;1975;182652;10302
Syddanmark;10-1-2021;M;74;1;4;1976;182726;10306
Hovedstaden;11-1-2021;F;365;7;31;1983;183091;10337
Midtjylland;11-1-2021;F;104;1;9;1984;183195;10346
Nordjylland;11-1-2021;F;57;1;1;1985;183252;10347
Sjælland;11-1-2021;F;127;4;11;1989;183379;10358
Syddanmark;11-1-2021;F;114;2;9;1991;183493;10367
Hovedstaden;11-1-2021;M;249;9;19;2000;183742;10386
Midtjylland;11-1-2021;M;92;3;7;2003;183834;10393
Nordjylland;11-1-2021;M;50;0;1;2003;183884;10394
Sjælland;11-1-2021;M;97;1;12;2004;183981;10406
Syddanmark;11-1-2021;M;92;2;10;2006;184073;10416
Hovedstaden;12-1-2021;F;317;10;28;2016;184390;10444
Midtjylland;12-1-2021;F;97;3;9;2019;184487;10453
Nordjylland;12-1-2021;F;53;1;2;2020;184540;10455
Sjælland;12-1-2021;F;124;1;7;2021;184664;10462
Syddanmark;12-1-2021;F;73;0;3;2021;184737;10465
Hovedstaden;12-1-2021;M;269;4;20;2025;185006;10485
Midtjylland;12-1-2021;M;81;2;5;2027;185087;10490
Nordjylland;12-1-2021;M;51;0;3;2027;185138;10493
Sjælland;12-1-2021;M;110;5;10;2032;185248;10503
Syddanmark;12-1-2021;M;79;2;6;2034;185327;10509
Hovedstaden;13-1-2021;F;269;7;25;2041;185596;10534
Midtjylland;13-1-2021;F;102;2;0;2043;185698;10534
Nordjylland;13-1-2021;F;65;2;4;2045;185763;10538
Sjælland;13-1-2021;F;76;2;12;2047;185839;10550
Syddanmark;13-1-2021;F;83;1;1;2048;185922;10551
Hovedstaden;13-1-2021;M;244;3;27;2051;186166;10578
Midtjylland;13-1-2021;M;69;0;4;2051;186235;10582
Nordjylland;13-1-2021;M;54;2;4;2053;186289;10586
Sjælland;13-1-2021;M;81;3;13;2056;186370;10599
Syddanmark;13-1-2021;M;68;0;2;2056;186438;10601
Hovedstaden;14-1-2021;F;222;4;16;2060;186660;10617
Midtjylland;14-1-2021;F;105;1;4;2061;186765;10621
Nordjylland;14-1-2021;F;49;0;1;2061;186814;10622
Sjælland;14-1-2021;F;97;1;7;2062;186911;10629
Syddanmark;14-1-2021;F;86;1;4;2063;186997;10633
Hovedstaden;14-1-2021;M;200;9;25;2072;187197;10658
Midtjylland;14-1-2021;M;82;1;7;2073;187279;10665
Nordjylland;14-1-2021;M;47;0;1;2073;187326;10666
Sjælland;14-1-2021;M;49;1;4;2074;187375;10670
Syddanmark;14-1-2021;M;64;0;2;2074;187439;10672
Hovedstaden;15-1-2021;F;200;2;13;2076;187639;10685
Midtjylland;15-1-2021;F;64;2;6;2078;187703;10691
Nordjylland;15-1-2021;F;33;0;1;2078;187736;10692
Sjælland;15-1-2021;F;67;2;5;2080;187803;10697
Syddanmark;15-1-2021;F;70;0;6;2080;187873;10703
Hovedstaden;15-1-2021;M;190;3;15;2083;188063;10718
Midtjylland;15-1-2021;M;53;2;8;2085;188116;10726
Nordjylland;15-1-2021;M;50;2;7;2087;188166;10733
Sjælland;15-1-2021;M;65;3;10;2090;188231;10743
Syddanmark;15-1-2021;M;58;2;7;2092;188289;10750
Hovedstaden;16-1-2021;F;176;5;11;2097;188465;10761
Midtjylland;16-1-2021;F;35;1;3;2098;188500;10764
Nordjylland;16-1-2021;F;37;0;1;2098;188537;10765
Sjælland;16-1-2021;F;50;1;2;2099;188587;10767
Syddanmark;16-1-2021;F;73;2;10;2101;188660;10777
Hovedstaden;16-1-2021;M;163;3;20;2104;188823;10797
Midtjylland;16-1-2021;M;37;0;3;2104;188860;10800
Nordjylland;16-1-2021;M;37;2;5;2106;188897;10805
Sjælland;16-1-2021;M;55;0;4;2106;188952;10809
Syddanmark;16-1-2021;M;54;0;6;2106;189006;10815
Hovedstaden;17-1-2021;F;170;2;16;2108;189176;10831
Midtjylland;17-1-2021;F;43;0;2;2108;189219;10833
Nordjylland;17-1-2021;F;29;2;2;2110;189248;10835
Sjælland;17-1-2021;F;63;0;9;2110;189311;10844
Syddanmark;17-1-2021;F;49;1;2;2111;189360;10846
Hovedstaden;17-1-2021;M;149;3;17;2114;189509;10863
Midtjylland;17-1-2021;M;35;0;1;2114;189544;10864
Nordjylland;17-1-2021;M;36;2;4;2116;189580;10868
Sjælland;17-1-2021;M;52;1;7;2117;189632;10875
Syddanmark;17-1-2021;M;48;0;4;2117;189680;10879
Hovedstaden;18-1-2021;F;235;6;23;2123;189915;10902
Midtjylland;18-1-2021;F;65;1;3;2124;189980;10905
Nordjylland;18-1-2021;F;42;0;4;2124;190022;10909
Sjælland;18-1-2021;F;78;2;6;2126;190100;10915
Syddanmark;18-1-2021;F;77;2;6;2128;190177;10921
Hovedstaden;18-1-2021;M;204;8;36;2136;190381;10957
Midtjylland;18-1-2021;M;54;1;5;2137;190435;10962
Nordjylland;18-1-2021;M;31;3;4;2140;190466;10966
Sjælland;18-1-2021;M;62;1;11;2141;190528;10977
Syddanmark;18-1-2021;M;75;0;3;2141;190603;10980
Hovedstaden;19-1-2021;F;188;2;18;2143;190791;10998
Midtjylland;19-1-2021;F;65;1;3;2144;190856;11001
Nordjylland;19-1-2021;F;43;1;6;2145;190899;11007
Sjælland;19-1-2021;F;84;1;6;2146;190983;11013
Syddanmark;19-1-2021;F;80;3;3;2149;191063;11016
Hovedstaden;19-1-2021;M;174;7;25;2156;191237;11041
Midtjylland;19-1-2021;M;47;2;7;2158;191284;11048
Nordjylland;19-1-2021;M;50;3;7;2161;191334;11055
Sjælland;19-1-2021;M;80;1;10;2162;191414;11065
Syddanmark;19-1-2021;M;101;3;7;2165;191515;11072
Hovedstaden;20-1-2021;F;163;3;10;2168;191678;11082
Midtjylland;20-1-2021;F;60;1;2;2169;191738;11084
Nordjylland;20-1-2021;F;41;2;5;2171;191779;11089
Sjælland;20-1-2021;F;71;1;7;2172;191850;11096
Syddanmark;20-1-2021;F;57;1;5;2173;191907;11101
Hovedstaden;20-1-2021;M;153;3;10;2176;192060;11111
Midtjylland;20-1-2021;M;50;0;8;2176;192110;11119
Nordjylland;20-1-2021;M;39;0;5;2176;192149;11124
Sjælland;20-1-2021;M;78;0;4;2176;192227;11128
Syddanmark;20-1-2021;M;61;0;5;2176;192288;11133
Hovedstaden;21-1-2021;F;190;5;19;2181;192478;11152
Midtjylland;21-1-2021;F;63;1;4;2182;192541;11156
Nordjylland;21-1-2021;F;46;0;3;2182;192587;11159
Sjælland;21-1-2021;F;75;0;5;2182;192662;11164
Syddanmark;21-1-2021;F;57;2;5;2184;192719;11169
Hovedstaden;21-1-2021;M;186;5;24;2189;192905;11193
Midtjylland;21-1-2021;M;57;0;5;2189;192962;11198
Nordjylland;21-1-2021;M;29;0;2;2189;192991;11200
Sjælland;21-1-2021;M;71;0;11;2189;193062;11211
Syddanmark;21-1-2021;M;78;2;5;2191;193140;11216
Hovedstaden;22-1-2021;F;148;5;8;2196;193288;11224
Midtjylland;22-1-2021;F;51;1;4;2197;193339;11228
Nordjylland;22-1-2021;F;40;1;3;2198;193379;11231
Sjælland;22-1-2021;F;74;2;9;2200;193453;11240
Syddanmark;22-1-2021;F;52;1;3;2201;193505;11243
Hovedstaden;22-1-2021;M;138;3;11;2204;193643;11254
Midtjylland;22-1-2021;M;44;1;2;2205;193687;11256
Nordjylland;22-1-2021;M;43;3;5;2208;193730;11261
Sjælland;22-1-2021;M;56;1;6;2209;193786;11267
Syddanmark;22-1-2021;M;64;0;2;2209;193850;11269
Hovedstaden;23-1-2021;F;137;2;12;2211;193987;11281
Midtjylland;23-1-2021;F;42;1;2;2212;194029;11283
Nordjylland;23-1-2021;F;20;0;1;2212;194049;11284
Sjælland;23-1-2021;F;54;2;5;2214;194103;11289
Syddanmark;23-1-2021;F;44;0;3;2214;194147;11292
Hovedstaden;23-1-2021;M;119;2;13;2216;194266;11305
Midtjylland;23-1-2021;M;42;0;5;2216;194308;11310
Nordjylland;23-1-2021;M;24;1;3;2217;194332;11313
Sjælland;23-1-2021;M;46;1;4;2218;194378;11317
Syddanmark;23-1-2021;M;59;1;3;2219;194437;11320
Hovedstaden;24-1-2021;F;124;0;12;2219;194561;11332
Midtjylland;24-1-2021;F;32;1;0;2220;194593;11332
Nordjylland;24-1-2021;F;28;1;4;2221;194621;11336
Sjælland;24-1-2021;F;42;3;4;2224;194663;11340
Syddanmark;24-1-2021;F;48;0;1;2224;194711;11341
Hovedstaden;24-1-2021;M;121;2;11;2226;194832;11352
Midtjylland;24-1-2021;M;23;1;2;2227;194855;11354
Nordjylland;24-1-2021;M;29;0;1;2227;194884;11355
Sjælland;24-1-2021;M;42;0;4;2227;194926;11359
Syddanmark;24-1-2021;M;23;0;1;2227;194949;11360
Hovedstaden;25-1-2021;F;160;5;11;2232;195109;11371
Midtjylland;25-1-2021;F;42;0;5;2232;195151;11376
Nordjylland;25-1-2021;F;28;0;2;2232;195179;11378
Sjælland;25-1-2021;F;68;1;8;2233;195247;11386
Syddanmark;25-1-2021;F;50;0;4;2233;195297;11390
Hovedstaden;25-1-2021;M;171;3;16;2236;195468;11406
Midtjylland;25-1-2021;M;41;0;2;2236;195509;11408
Nordjylland;25-1-2021;M;23;0;2;2236;195532;11410
Sjælland;25-1-2021;M;63;0;6;2236;195595;11416
Syddanmark;25-1-2021;M;73;0;6;2236;195668;11422
Hovedstaden;26-1-2021;F;141;1;8;2237;195809;11430
Midtjylland;26-1-2021;F;47;0;3;2237;195856;11433
Nordjylland;26-1-2021;F;34;0;0;2237;195890;11433
Sjælland;26-1-2021;F;68;0;5;2237;195958;11438
Syddanmark;26-1-2021;F;59;0;1;2237;196017;11439
Hovedstaden;26-1-2021;M;135;2;12;2239;196152;11451
Midtjylland;26-1-2021;M;47;3;4;2242;196199;11455
Nordjylland;26-1-2021;M;33;0;4;2242;196232;11459
Sjælland;26-1-2021;M;67;1;6;2243;196299;11465
Syddanmark;26-1-2021;M;47;0;0;2243;196346;11465
Hovedstaden;27-1-2021;F;139;1;12;2244;196485;11477
Midtjylland;27-1-2021;F;35;0;1;2244;196520;11478
Nordjylland;27-1-2021;F;13;0;1;2244;196533;11479
Sjælland;27-1-2021;F;50;1;3;2245;196583;11482
Syddanmark;27-1-2021;F;39;1;3;2246;196622;11485
Hovedstaden;27-1-2021;M;111;4;11;2250;196733;11496
Midtjylland;27-1-2021;M;28;1;3;2251;196761;11499
Nordjylland;27-1-2021;M;23;0;2;2251;196784;11501
Sjælland;27-1-2021;M;52;3;8;2254;196836;11509
Syddanmark;27-1-2021;M;40;0;3;2254;196876;11512
Hovedstaden;28-1-2021;F;131;2;11;2256;197007;11523
Midtjylland;28-1-2021;F;43;1;4;2257;197050;11527
Nordjylland;28-1-2021;F;22;0;0;2257;197072;11527
Sjælland;28-1-2021;F;50;0;5;2257;197122;11532
Syddanmark;28-1-2021;F;30;0;2;2257;197152;11534
Hovedstaden;28-1-2021;M;105;4;9;2261;197257;11543
Midtjylland;28-1-2021;M;28;0;1;2261;197285;11544
Nordjylland;28-1-2021;M;17;2;2;2263;197302;11546
Sjælland;28-1-2021;M;33;0;4;2263;197335;11550
Syddanmark;28-1-2021;M;39;1;1;2264;197374;11551
Hovedstaden;29-1-2021;F;99;4;6;2268;197473;11557
Midtjylland;29-1-2021;F;19;0;2;2268;197492;11559
Nordjylland;29-1-2021;F;17;0;2;2268;197509;11561
Sjælland;29-1-2021;F;38;1;5;2269;197547;11566
Syddanmark;29-1-2021;F;34;0;0;2269;197581;11566
Hovedstaden;29-1-2021;M;84;3;8;2272;197665;11574
Midtjylland;29-1-2021;M;26;1;3;2273;197691;11577
Nordjylland;29-1-2021;M;14;0;3;2273;197705;11580
Sjælland;29-1-2021;M;24;0;3;2273;197729;11583
Syddanmark;29-1-2021;M;47;1;0;2274;197776;11583
Hovedstaden;30-1-2021;F;74;4;8;2278;197850;11591
Midtjylland;30-1-2021;F;12;0;1;2278;197862;11592
Nordjylland;30-1-2021;F;12;0;1;2278;197874;11593
Sjælland;30-1-2021;F;31;0;3;2278;197905;11596
Syddanmark;30-1-2021;F;36;0;2;2278;197941;11598
Hovedstaden;30-1-2021;M;91;0;7;2278;198032;11605
Midtjylland;30-1-2021;M;26;0;0;2278;198058;11605
Nordjylland;30-1-2021;M;16;1;1;2279;198074;11606
Sjælland;30-1-2021;M;25;0;2;2279;198099;11608
Syddanmark;30-1-2021;M;34;0;1;2279;198133;11609
Hovedstaden;31-1-2021;F;85;3;7;2282;198218;11616
Midtjylland;31-1-2021;F;25;1;2;2283;198243;11618
Nordjylland;31-1-2021;F;12;0;0;2283;198255;11618
Sjælland;31-1-2021;F;25;0;3;2283;198280;11621
Syddanmark;31-1-2021;F;30;1;2;2284;198310;11623
Hovedstaden;31-1-2021;M;91;0;10;2284;198401;11633
Midtjylland;31-1-2021;M;20;0;3;2284;198421;11636
Nordjylland;31-1-2021;M;20;0;1;2284;198441;11637
Sjælland;31-1-2021;M;36;0;4;2284;198477;11641
Syddanmark;31-1-2021;M;36;0;3;2284;198513;11644
Hovedstaden;1-2-2021;F;99;1;8;2285;198612;11652
Midtjylland;1-2-2021;F;36;0;3;2285;198648;11655
Nordjylland;1-2-2021;F;24;0;2;2285;198672;11657
Sjælland;1-2-2021;F;52;0;3;2285;198724;11660
Syddanmark;1-2-2021;F;52;1;5;2286;198776;11665
Hovedstaden;1-2-2021;M;108;5;13;2291;198884;11678
Midtjylland;1-2-2021;M;29;0;3;2291;198913;11681
Nordjylland;1-2-2021;M;23;1;4;2292;198936;11685
Sjælland;1-2-2021;M;36;1;4;2293;198972;11689
Syddanmark;1-2-2021;M;41;1;4;2294;199013;11693
Hovedstaden;2-2-2021;F;94;0;8;2294;199107;11701
Midtjylland;2-2-2021;F;34;0;1;2294;199141;11702
Nordjylland;2-2-2021;F;22;0;1;2294;199163;11703
Sjælland;2-2-2021;F;42;0;3;2294;199205;11706
Syddanmark;2-2-2021;F;51;3;8;2297;199256;11714
Hovedstaden;2-2-2021;M;112;4;11;2301;199368;11725
Midtjylland;2-2-2021;M;28;0;1;2301;199396;11726
Nordjylland;2-2-2021;M;23;1;2;2302;199419;11728
Sjælland;2-2-2021;M;34;0;2;2302;199453;11730
Syddanmark;2-2-2021;M;42;1;5;2303;199495;11735
Hovedstaden;3-2-2021;F;74;0;4;2303;199569;11739
Midtjylland;3-2-2021;F;21;0;1;2303;199590;11740
Nordjylland;3-2-2021;F;23;1;1;2304;199613;11741
Sjælland;3-2-2021;F;41;1;4;2305;199654;11745
Syddanmark;3-2-2021;F;53;1;2;2306;199707;11747
Hovedstaden;3-2-2021;M;82;0;5;2306;199789;11752
Midtjylland;3-2-2021;M;34;0;1;2306;199823;11753
Nordjylland;3-2-2021;M;19;0;3;2306;199842;11756
Sjælland;3-2-2021;M;31;1;3;2307;199873;11759
Syddanmark;3-2-2021;M;46;1;4;2308;199919;11763
Hovedstaden;4-2-2021;F;94;2;7;2310;200013;11770
Midtjylland;4-2-2021;F;36;0;0;2310;200049;11770
Nordjylland;4-2-2021;F;17;1;2;2311;200066;11772
Sjælland;4-2-2021;F;30;1;2;2312;200096;11774
Syddanmark;4-2-2021;F;34;0;2;2312;200130;11776
Hovedstaden;4-2-2021;M;103;0;11;2312;200233;11787
Midtjylland;4-2-2021;M;32;0;1;2312;200265;11788
Nordjylland;4-2-2021;M;13;0;1;2312;200278;11789
Sjælland;4-2-2021;M;44;0;6;2312;200322;11795
Syddanmark;4-2-2021;M;35;0;0;2312;200357;11795
Hovedstaden;5-2-2021;F;88;0;5;2312;200445;11800
Midtjylland;5-2-2021;F;35;0;1;2312;200480;11801
Nordjylland;5-2-2021;F;21;0;1;2312;200501;11802
Sjælland;5-2-2021;F;25;2;4;2314;200526;11806
Syddanmark;5-2-2021;F;32;1;0;2315;200558;11806
Hovedstaden;5-2-2021;M;80;2;10;2317;200638;11816
Midtjylland;5-2-2021;M;32;0;2;2317;200670;11818
Nordjylland;5-2-2021;M;12;0;1;2317;200682;11819
Sjælland;5-2-2021;M;36;1;6;2318;200718;11825
Syddanmark;5-2-2021;M;43;1;1;2319;200761;11826
Hovedstaden;6-2-2021;F;96;0;9;2319;200857;11835
Midtjylland;6-2-2021;F;30;0;3;2319;200887;11838
Nordjylland;6-2-2021;F;19;1;4;2320;200906;11842
Sjælland;6-2-2021;F;36;0;2;2320;200942;11844
Syddanmark;6-2-2021;F;44;0;2;2320;200986;11846
Hovedstaden;6-2-2021;M;71;0;1;2320;201057;11847
Midtjylland;6-2-2021;M;39;0;2;2320;201096;11849
Nordjylland;6-2-2021;M;11;0;1;2320;201107;11850
Sjælland;6-2-2021;M;31;1;3;2321;201138;11853
Syddanmark;6-2-2021;M;50;1;3;2322;201188;11856
Hovedstaden;7-2-2021;F;100;6;14;2328;201288;11870
Midtjylland;7-2-2021;F;32;0;1;2328;201320;11871
Nordjylland;7-2-2021;F;20;0;1;2328;201340;11872
Sjælland;7-2-2021;F;26;0;3;2328;201366;11875
Syddanmark;7-2-2021;F;35;1;2;2329;201401;11877
Hovedstaden;7-2-2021;M;70;2;8;2331;201471;11885
Midtjylland;7-2-2021;M;44;0;2;2331;201515;11887
Nordjylland;7-2-2021;M;13;0;2;2331;201528;11889
Sjælland;7-2-2021;M;20;0;0;2331;201548;11889
Syddanmark;7-2-2021;M;27;1;0;2332;201575;11889
Hovedstaden;8-2-2021;F;89;1;11;2333;201664;11900
Midtjylland;8-2-2021;F;28;0;1;2333;201692;11901
Nordjylland;8-2-2021;F;25;0;1;2333;201717;11902
Sjælland;8-2-2021;F;55;0;8;2333;201772;11910
Syddanmark;8-2-2021;F;40;0;6;2333;201812;11916
Hovedstaden;8-2-2021;M;71;1;4;2334;201883;11920
Midtjylland;8-2-2021;M;39;0;2;2334;201922;11922
Nordjylland;8-2-2021;M;13;1;3;2335;201935;11925
Sjælland;8-2-2021;M;48;1;6;2336;201983;11931
Syddanmark;8-2-2021;M;29;0;2;2336;202012;11933
Hovedstaden;9-2-2021;F;90;2;11;2338;202102;11944
Midtjylland;9-2-2021;F;25;0;0;2338;202127;11944
Nordjylland;9-2-2021;F;22;0;2;2338;202149;11946
Sjælland;9-2-2021;F;37;0;3;2338;202186;11949
Syddanmark;9-2-2021;F;45;1;3;2339;202231;11952
Hovedstaden;9-2-2021;M;88;0;5;2339;202319;11957
Midtjylland;9-2-2021;M;47;0;1;2339;202366;11958
Nordjylland;9-2-2021;M;14;0;2;2339;202380;11960
Sjælland;9-2-2021;M;36;0;5;2339;202416;11965
Syddanmark;9-2-2021;M;53;1;3;2340;202469;11968
Hovedstaden;10-2-2021;F;81;0;7;2340;202550;11975
Midtjylland;10-2-2021;F;43;2;3;2342;202593;11978
Nordjylland;10-2-2021;F;21;0;3;2342;202614;11981
Sjælland;10-2-2021;F;36;0;4;2342;202650;11985
Syddanmark;10-2-2021;F;35;0;1;2342;202685;11986
Hovedstaden;10-2-2021;M;95;1;6;2343;202780;11992
Midtjylland;10-2-2021;M;45;0;3;2343;202825;11995
Nordjylland;10-2-2021;M;23;0;3;2343;202848;11998
Sjælland;10-2-2021;M;26;0;2;2343;202874;12000
Syddanmark;10-2-2021;M;40;1;1;2344;202914;12001
Hovedstaden;11-2-2021;F;82;2;1;2346;202996;12002
Midtjylland;11-2-2021;F;32;0;0;2346;203028;12002
Nordjylland;11-2-2021;F;11;0;0;2346;203039;12002
Sjælland;11-2-2021;F;43;0;2;2346;203082;12004
Syddanmark;11-2-2021;F;36;0;2;2346;203118;12006
Hovedstaden;11-2-2021;M;66;1;4;2347;203184;12010
Midtjylland;11-2-2021;M;27;0;3;2347;203211;12013
Nordjylland;11-2-2021;M;9;1;1;2348;203220;12014
Sjælland;11-2-2021;M;39;1;5;2349;203259;12019
Syddanmark;11-2-2021;M;23;0;0;2349;203282;12019
Hovedstaden;12-2-2021;F;68;1;5;2350;203350;12024
Midtjylland;12-2-2021;F;20;0;1;2350;203370;12025
Nordjylland;12-2-2021;F;17;0;0;2350;203387;12025
Sjælland;12-2-2021;F;25;0;2;2350;203412;12027
Syddanmark;12-2-2021;F;20;0;0;2350;203432;12027
Hovedstaden;12-2-2021;M;77;0;8;2350;203509;12035
Midtjylland;12-2-2021;M;19;0;2;2350;203528;12037
Nordjylland;12-2-2021;M;16;0;1;2350;203544;12038
Sjælland;12-2-2021;M;27;0;2;2350;203571;12040
Syddanmark;12-2-2021;M;26;0;2;2350;203597;12042
Hovedstaden;13-2-2021;F;62;0;3;2350;203659;12045
Midtjylland;13-2-2021;F;25;0;3;2350;203684;12048
Nordjylland;13-2-2021;F;16;0;3;2350;203700;12051
Sjælland;13-2-2021;F;19;0;1;2350;203719;12052
Syddanmark;13-2-2021;F;42;0;3;2350;203761;12055
Hovedstaden;13-2-2021;M;63;1;5;2351;203824;12060
Midtjylland;13-2-2021;M;31;1;0;2352;203855;12060
Nordjylland;13-2-2021;M;15;0;0;2352;203870;12060
Sjælland;13-2-2021;M;12;0;0;2352;203882;12060
Syddanmark;13-2-2021;M;46;0;3;2352;203928;12063
Hovedstaden;14-2-2021;F;58;0;3;2352;203986;12066
Midtjylland;14-2-2021;F;18;0;2;2352;204004;12068
Nordjylland;14-2-2021;F;15;0;2;2352;204019;12070
Sjælland;14-2-2021;F;25;0;2;2352;204044;12072
Syddanmark;14-2-2021;F;48;0;1;2352;204092;12073
Hovedstaden;14-2-2021;M;65;1;3;2353;204157;12076
Midtjylland;14-2-2021;M;26;0;1;2353;204183;12077
Nordjylland;14-2-2021;M;19;0;0;2353;204202;12077
Sjælland;14-2-2021;M;21;1;2;2354;204223;12079
Syddanmark;14-2-2021;M;43;0;3;2354;204266;12082
Hovedstaden;15-2-2021;F;82;0;2;2354;204348;12084
Midtjylland;15-2-2021;F;34;0;1;2354;204382;12085
Nordjylland;15-2-2021;F;22;0;2;2354;204404;12087
Sjælland;15-2-2021;F;26;0;0;2354;204430;12087
Syddanmark;15-2-2021;F;49;0;2;2354;204479;12089
Hovedstaden;15-2-2021;M;78;1;7;2355;204557;12096
Midtjylland;15-2-2021;M;29;2;2;2357;204586;12098
Nordjylland;15-2-2021;M;11;0;1;2357;204597;12099
Sjælland;15-2-2021;M;22;0;2;2357;204619;12101
Syddanmark;15-2-2021;M;45;0;6;2357;204664;12107
Hovedstaden;16-2-2021;F;86;0;5;2357;204750;12112
Midtjylland;16-2-2021;F;35;0;0;2357;204785;12112
Nordjylland;16-2-2021;F;11;0;0;2357;204796;12112
Sjælland;16-2-2021;F;31;0;3;2357;204827;12115
Syddanmark;16-2-2021;F;89;0;4;2357;204916;12119
Hovedstaden;16-2-2021;M;78;0;5;2357;204994;12124
Midtjylland;16-2-2021;M;49;0;2;2357;205043;12126
Nordjylland;16-2-2021;M;10;0;0;2357;205053;12126
Sjælland;16-2-2021;M;32;0;3;2357;205085;12129
Syddanmark;16-2-2021;M;97;0;4;2357;205182;12133
Hovedstaden;17-2-2021;F;92;0;4;2357;205274;12137
Midtjylland;17-2-2021;F;35;0;2;2357;205309;12139
Nordjylland;17-2-2021;F;11;0;2;2357;205320;12141
Sjælland;17-2-2021;F;20;0;0;2357;205340;12141
Syddanmark;17-2-2021;F;84;0;2;2357;205424;12143
Hovedstaden;17-2-2021;M;92;1;7;2358;205516;12150
Midtjylland;17-2-2021;M;41;0;4;2358;205557;12154
Nordjylland;17-2-2021;M;19;0;0;2358;205576;12154
Sjælland;17-2-2021;M;28;0;4;2358;205604;12158
Syddanmark;17-2-2021;M;83;0;5;2358;205687;12163
Hovedstaden;18-2-2021;F;75;0;2;2358;205762;12165
Midtjylland;18-2-2021;F;36;0;0;2358;205798;12165
Nordjylland;18-2-2021;F;37;0;2;2358;205835;12167
Sjælland;18-2-2021;F;29;0;1;2358;205864;12168
Syddanmark;18-2-2021;F;80;0;3;2358;205944;12171
Hovedstaden;18-2-2021;M;70;1;6;2359;206014;12177
Midtjylland;18-2-2021;M;51;0;5;2359;206065;12182
Nordjylland;18-2-2021;M;37;0;3;2359;206102;12185
Sjælland;18-2-2021;M;38;1;5;2360;206140;12190
Syddanmark;18-2-2021;M;88;0;4;2360;206228;12194
Hovedstaden;19-2-2021;F;86;3;6;2363;206314;12200
Midtjylland;19-2-2021;F;27;0;1;2363;206341;12201
Nordjylland;19-2-2021;F;6;0;1;2363;206347;12202
Sjælland;19-2-2021;F;40;0;2;2363;206387;12204
Syddanmark;19-2-2021;F;56;0;4;2363;206443;12208
Hovedstaden;19-2-2021;M;95;0;9;2363;206538;12217
Midtjylland;19-2-2021;M;23;0;0;2363;206561;12217
Nordjylland;19-2-2021;M;20;0;3;2363;206581;12220
Sjælland;19-2-2021;M;37;0;4;2363;206618;12224
Syddanmark;19-2-2021;M;66;0;1;2363;206684;12225
Hovedstaden;20-2-2021;F;75;1;8;2364;206759;12233
Midtjylland;20-2-2021;F;32;0;2;2364;206791;12235
Nordjylland;20-2-2021;F;15;0;0;2364;206806;12235
Sjælland;20-2-2021;F;28;0;0;2364;206834;12235
Syddanmark;20-2-2021;F;53;0;2;2364;206887;12237
Hovedstaden;20-2-2021;M;79;0;9;2364;206966;12246
Midtjylland;20-2-2021;M;33;0;1;2364;206999;12247
Nordjylland;20-2-2021;M;11;0;0;2364;207010;12247
Sjælland;20-2-2021;M;33;1;1;2365;207043;12248
Syddanmark;20-2-2021;M;71;0;3;2365;207114;12251
Hovedstaden;21-2-2021;F;71;0;5;2365;207185;12256
Midtjylland;21-2-2021;F;40;0;0;2365;207225;12256
Nordjylland;21-2-2021;F;9;0;1;2365;207234;12257
Sjælland;21-2-2021;F;21;0;1;2365;207255;12258
Syddanmark;21-2-2021;F;84;0;5;2365;207339;12263
Hovedstaden;21-2-2021;M;91;0;7;2365;207430;12270
Midtjylland;21-2-2021;M;40;0;2;2365;207470;12272
Nordjylland;21-2-2021;M;12;0;1;2365;207482;12273
Sjælland;21-2-2021;M;37;0;3;2365;207519;12276
Syddanmark;21-2-2021;M;67;0;4;2365;207586;12280
Hovedstaden;22-2-2021;F;93;0;6;2365;207679;12286
Midtjylland;22-2-2021;F;44;0;2;2365;207723;12288
Nordjylland;22-2-2021;F;20;0;0;2365;207743;12288
Sjælland;22-2-2021;F;50;1;4;2366;207793;12292
Syddanmark;22-2-2021;F;91;0;4;2366;207884;12296
Hovedstaden;22-2-2021;M;103;0;3;2366;207987;12299
Midtjylland;22-2-2021;M;38;0;0;2366;208025;12299
Nordjylland;22-2-2021;M;19;0;2;2366;208044;12301
Sjælland;22-2-2021;M;43;0;5;2366;208087;12306
Syddanmark;22-2-2021;M;82;0;2;2366;208169;12308
Hovedstaden;23-2-2021;F;132;0;6;2366;208301;12314
Midtjylland;23-2-2021;F;21;0;0;2366;208322;12314
Nordjylland;23-2-2021;F;24;1;2;2367;208346;12316
Sjælland;23-2-2021;F;47;0;2;2367;208393;12318
Syddanmark;23-2-2021;F;71;0;5;2367;208464;12323
Hovedstaden;23-2-2021;M;122;0;8;2367;208586;12331
Midtjylland;23-2-2021;M;40;0;3;2367;208626;12334
Nordjylland;23-2-2021;M;17;0;1;2367;208643;12335
Sjælland;23-2-2021;M;52;1;6;2368;208695;12341
Syddanmark;23-2-2021;M;74;0;5;2368;208769;12346
Hovedstaden;24-2-2021;F;120;3;11;2371;208889;12357
Midtjylland;24-2-2021;F;33;0;0;2371;208922;12357
Nordjylland;24-2-2021;F;13;0;2;2371;208935;12359
Sjælland;24-2-2021;F;49;0;1;2371;208984;12360
Syddanmark;24-2-2021;F;60;0;5;2371;209044;12365
Hovedstaden;24-2-2021;M;110;0;9;2371;209154;12374
Midtjylland;24-2-2021;M;27;0;0;2371;209181;12374
Nordjylland;24-2-2021;M;12;0;1;2371;209193;12375
Sjælland;24-2-2021;M;40;0;1;2371;209233;12376
Syddanmark;24-2-2021;M;71;0;6;2371;209304;12382
Hovedstaden;25-2-2021;F;110;0;6;2371;209414;12388
Midtjylland;25-2-2021;F;30;0;1;2371;209444;12389
Nordjylland;25-2-2021;F;14;0;0;2371;209458;12389
Sjælland;25-2-2021;F;61;0;7;2371;209519;12396
Syddanmark;25-2-2021;F;54;0;6;2371;209573;12402
Hovedstaden;25-2-2021;M;118;1;5;2372;209691;12407
Midtjylland;25-2-2021;M;32;0;4;2372;209723;12411
Nordjylland;25-2-2021;M;13;0;0;2372;209736;12411
Sjælland;25-2-2021;M;43;0;2;2372;209779;12413
Syddanmark;25-2-2021;M;62;0;1;2372;209841;12414
Hovedstaden;26-2-2021;F;121;0;8;2372;209962;12422
Midtjylland;26-2-2021;F;19;0;0;2372;209981;12422
Nordjylland;26-2-2021;F;8;0;0;2372;209989;12422
Sjælland;26-2-2021;F;34;0;1;2372;210023;12423
Syddanmark;26-2-2021;F;65;0;3;2372;210088;12426
Hovedstaden;26-2-2021;M;110;0;4;2372;210198;12430
Midtjylland;26-2-2021;M;26;0;3;2372;210224;12433
Nordjylland;26-2-2021;M;12;0;0;2372;210236;12433
Sjælland;26-2-2021;M;32;1;5;2373;210268;12438
Syddanmark;26-2-2021;M;65;0;4;2373;210333;12442
Hovedstaden;27-2-2021;F;103;1;4;2374;210436;12446
Midtjylland;27-2-2021;F;25;0;2;2374;210461;12448
Nordjylland;27-2-2021;F;12;0;0;2374;210473;12448
Sjælland;27-2-2021;F;31;0;1;2374;210504;12449
Syddanmark;27-2-2021;F;46;1;2;2375;210550;12451
Hovedstaden;27-2-2021;M;98;0;5;2375;210648;12456
Midtjylland;27-2-2021;M;25;0;1;2375;210673;12457
Nordjylland;27-2-2021;M;8;0;0;2375;210681;12457
Sjælland;27-2-2021;M;31;0;4;2375;210712;12461
Syddanmark;27-2-2021;M;43;0;4;2375;210755;12465
Hovedstaden;28-2-2021;F;118;0;6;2375;210873;12471
Midtjylland;28-2-2021;F;26;0;1;2375;210899;12472
Nordjylland;28-2-2021;F;13;0;0;2375;210912;12472
Sjælland;28-2-2021;F;21;0;1;2375;210933;12473
Syddanmark;28-2-2021;F;58;1;5;2376;210991;12478
Hovedstaden;28-2-2021;M;117;0;4;2376;211108;12482
Midtjylland;28-2-2021;M;20;0;1;2376;211128;12483
Nordjylland;28-2-2021;M;13;0;1;2376;211141;12484
Sjælland;28-2-2021;M;28;0;2;2376;211169;12486
Syddanmark;28-2-2021;M;57;0;2;2376;211226;12488
Hovedstaden;1-3-2021;F;135;0;4;2376;211361;12492
Midtjylland;1-3-2021;F;31;0;1;2376;211392;12493
Nordjylland;1-3-2021;F;18;0;0;2376;211410;12493
Sjælland;1-3-2021;F;56;0;4;2376;211466;12497
Syddanmark;1-3-2021;F;60;0;6;2376;211526;12503
Hovedstaden;1-3-2021;M;129;0;5;2376;211655;12508
Midtjylland;1-3-2021;M;33;0;0;2376;211688;12508
Nordjylland;1-3-2021;M;16;0;1;2376;211704;12509
Sjælland;1-3-2021;M;50;2;5;2378;211754;12514
Syddanmark;1-3-2021;M;63;1;2;2379;211817;12516
Hovedstaden;2-3-2021;F;121;2;6;2381;211938;12522
Midtjylland;2-3-2021;F;40;0;1;2381;211978;12523
Nordjylland;2-3-2021;F;8;0;1;2381;211986;12524
Sjælland;2-3-2021;F;49;0;4;2381;212035;12528
Syddanmark;2-3-2021;F;71;0;4;2381;212106;12532
Hovedstaden;2-3-2021;M;130;1;10;2382;212236;12542
Midtjylland;2-3-2021;M;42;0;1;2382;212278;12543
Nordjylland;2-3-2021;M;11;0;0;2382;212289;12543
Sjælland;2-3-2021;M;46;0;4;2382;212335;12547
Syddanmark;2-3-2021;M;75;0;4;2382;212410;12551
Hovedstaden;3-3-2021;F;104;0;3;2382;212514;12554
Midtjylland;3-3-2021;F;39;0;2;2382;212553;12556
Nordjylland;3-3-2021;F;10;0;0;2382;212563;12556
Sjælland;3-3-2021;F;41;0;3;2382;212604;12559
Syddanmark;3-3-2021;F;77;0;7;2382;212681;12566
Hovedstaden;3-3-2021;M;109;0;4;2382;212790;12570
Midtjylland;3-3-2021;M;35;0;0;2382;212825;12570
Nordjylland;3-3-2021;M;12;0;0;2382;212837;12570
Sjælland;3-3-2021;M;43;0;4;2382;212880;12574
Syddanmark;3-3-2021;M;70;1;5;2383;212950;12579
Hovedstaden;4-3-2021;F;120;0;4;2383;213070;12583
Midtjylland;4-3-2021;F;23;0;0;2383;213093;12583
Nordjylland;4-3-2021;F;10;0;0;2383;213103;12583
Sjælland;4-3-2021;F;41;0;0;2383;213144;12583
Syddanmark;4-3-2021;F;41;0;2;2383;213185;12585
Hovedstaden;4-3-2021;M;105;0;3;2383;213290;12588
Midtjylland;4-3-2021;M;24;0;0;2383;213314;12588
Nordjylland;4-3-2021;M;8;0;0;2383;213322;12588
Sjælland;4-3-2021;M;40;0;3;2383;213362;12591
Syddanmark;4-3-2021;M;69;0;3;2383;213431;12594
Hovedstaden;5-3-2021;F;97;0;8;2383;213528;12602
Midtjylland;5-3-2021;F;38;0;3;2383;213566;12605
Nordjylland;5-3-2021;F;7;0;0;2383;213573;12605
Sjælland;5-3-2021;F;30;0;0;2383;213603;12605
Syddanmark;5-3-2021;F;39;0;2;2383;213642;12607
Hovedstaden;5-3-2021;M;110;3;9;2386;213752;12616
Midtjylland;5-3-2021;M;20;0;1;2386;213772;12617
Nordjylland;5-3-2021;M;14;0;1;2386;213786;12618
Sjælland;5-3-2021;M;36;1;5;2387;213822;12623
Syddanmark;5-3-2021;M;73;0;3;2387;213895;12626
Hovedstaden;6-3-2021;F;107;0;4;2387;214002;12630
Midtjylland;6-3-2021;F;29;0;1;2387;214031;12631
Nordjylland;6-3-2021;F;8;0;0;2387;214039;12631
Sjælland;6-3-2021;F;30;0;2;2387;214069;12633
Syddanmark;6-3-2021;F;46;0;0;2387;214115;12633
Hovedstaden;6-3-2021;M;96;0;6;2387;214211;12639
Midtjylland;6-3-2021;M;17;0;0;2387;214228;12639
Nordjylland;6-3-2021;M;9;0;1;2387;214237;12640
Sjælland;6-3-2021;M;41;0;5;2387;214278;12645
Syddanmark;6-3-2021;M;64;0;5;2387;214342;12650
Hovedstaden;7-3-2021;F;103;0;7;2387;214445;12657
Midtjylland;7-3-2021;F;46;0;1;2387;214491;12658
Nordjylland;7-3-2021;F;13;0;0;2387;214504;12658
Sjælland;7-3-2021;F;27;0;3;2387;214531;12661
Syddanmark;7-3-2021;F;48;0;2;2387;214579;12663
Hovedstaden;7-3-2021;M;86;0;5;2387;214665;12668
Midtjylland;7-3-2021;M;27;0;2;2387;214692;12670
Nordjylland;7-3-2021;M;10;0;0;2387;214702;12670
Sjælland;7-3-2021;M;33;0;3;2387;214735;12673
Syddanmark;7-3-2021;M;59;0;0;2387;214794;12673
Hovedstaden;8-3-2021;F;110;0;7;2387;214904;12680
Midtjylland;8-3-2021;F;40;0;2;2387;214944;12682
Nordjylland;8-3-2021;F;14;0;0;2387;214958;12682
Sjælland;8-3-2021;F;47;1;3;2388;215005;12685
Syddanmark;8-3-2021;F;66;0;3;2388;215071;12688
Hovedstaden;8-3-2021;M;144;0;9;2388;215215;12697
Midtjylland;8-3-2021;M;52;0;2;2388;215267;12699
Nordjylland;8-3-2021;M;7;0;1;2388;215274;12700
Sjælland;8-3-2021;M;32;0;2;2388;215306;12702
Syddanmark;8-3-2021;M;83;0;1;2388;215389;12703
Hovedstaden;9-3-2021;F;118;0;6;2388;215507;12709
Midtjylland;9-3-2021;F;36;0;2;2388;215543;12711
Nordjylland;9-3-2021;F;5;0;0;2388;215548;12711
Sjælland;9-3-2021;F;41;0;3;2388;215589;12714
Syddanmark;9-3-2021;F;92;0;5;2388;215681;12719
Hovedstaden;9-3-2021;M;148;0;10;2388;215829;12729
Midtjylland;9-3-2021;M;53;0;1;2388;215882;12730
Nordjylland;9-3-2021;M;13;0;2;2388;215895;12732
Sjælland;9-3-2021;M;38;2;5;2390;215933;12737
Syddanmark;9-3-2021;M;94;0;3;2390;216027;12740
Hovedstaden;10-3-2021;F;112;1;6;2391;216139;12746
Midtjylland;10-3-2021;F;40;0;1;2391;216179;12747
Nordjylland;10-3-2021;F;8;0;0;2391;216187;12747
Sjælland;10-3-2021;F;27;0;2;2391;216214;12749
Syddanmark;10-3-2021;F;84;0;5;2391;216298;12754
Hovedstaden;10-3-2021;M;99;0;3;2391;216397;12757
Midtjylland;10-3-2021;M;39;0;2;2391;216436;12759
Nordjylland;10-3-2021;M;16;0;0;2391;216452;12759
Sjælland;10-3-2021;M;31;0;1;2391;216483;12760
Syddanmark;10-3-2021;M;81;0;4;2391;216564;12764
Hovedstaden;11-3-2021;F;135;0;7;2391;216699;12771
Midtjylland;11-3-2021;F;33;0;2;2391;216732;12773
Nordjylland;11-3-2021;F;16;1;2;2392;216748;12775
Sjælland;11-3-2021;F;36;1;1;2393;216784;12776
Syddanmark;11-3-2021;F;75;0;4;2393;216859;12780
Hovedstaden;11-3-2021;M;113;0;5;2393;216972;12785
Midtjylland;11-3-2021;M;36;0;2;2393;217008;12787
Nordjylland;11-3-2021;M;18;0;0;2393;217026;12787
Sjælland;11-3-2021;M;46;0;2;2393;217072;12789
Syddanmark;11-3-2021;M;72;0;3;2393;217144;12792
Hovedstaden;12-3-2021;F;109;0;2;2393;217253;12794
Midtjylland;12-3-2021;F;34;0;2;2393;217287;12796
Nordjylland;12-3-2021;F;13;0;0;2393;217300;12796
Sjælland;12-3-2021;F;31;0;2;2393;217331;12798
Syddanmark;12-3-2021;F;64;0;5;2393;217395;12803
Hovedstaden;12-3-2021;M;106;0;4;2393;217501;12807
Midtjylland;12-3-2021;M;27;0;2;2393;217528;12809
Nordjylland;12-3-2021;M;7;0;0;2393;217535;12809
Sjælland;12-3-2021;M;31;0;3;2393;217566;12812
Syddanmark;12-3-2021;M;57;0;2;2393;217623;12814
Hovedstaden;13-3-2021;F;85;0;5;2393;217708;12819
Midtjylland;13-3-2021;F;35;0;0;2393;217743;12819
Nordjylland;13-3-2021;F;10;0;0;2393;217753;12819
Sjælland;13-3-2021;F;24;0;2;2393;217777;12821
Syddanmark;13-3-2021;F;69;0;4;2393;217846;12825
Hovedstaden;13-3-2021;M;107;0;10;2393;217953;12835
Midtjylland;13-3-2021;M;25;0;1;2393;217978;12836
Nordjylland;13-3-2021;M;13;0;1;2393;217991;12837
Sjælland;13-3-2021;M;23;0;1;2393;218014;12838
Syddanmark;13-3-2021;M;70;0;2;2393;218084;12840
Hovedstaden;14-3-2021;F;94;0;6;2393;218178;12846
Midtjylland;14-3-2021;F;33;0;0;2393;218211;12846
Nordjylland;14-3-2021;F;13;0;0;2393;218224;12846
Sjælland;14-3-2021;F;25;0;1;2393;218249;12847
Syddanmark;14-3-2021;F;65;1;5;2394;218314;12852
Hovedstaden;14-3-2021;M;122;1;6;2395;218436;12858
Midtjylland;14-3-2021;M;36;0;0;2395;218472;12858
Nordjylland;14-3-2021;M;10;0;0;2395;218482;12858
Sjælland;14-3-2021;M;22;0;0;2395;218504;12858
Syddanmark;14-3-2021;M;66;0;1;2395;218570;12859
Hovedstaden;15-3-2021;F;122;0;5;2395;218692;12864
Midtjylland;15-3-2021;F;44;0;5;2395;218736;12869
Nordjylland;15-3-2021;F;13;0;0;2395;218749;12869
Sjælland;15-3-2021;F;41;1;2;2396;218790;12871
Syddanmark;15-3-2021;F;102;0;3;2396;218892;12874
Hovedstaden;15-3-2021;M;133;2;12;2398;219025;12886
Midtjylland;15-3-2021;M;38;0;2;2398;219063;12888
Nordjylland;15-3-2021;M;15;0;0;2398;219078;12888
Sjælland;15-3-2021;M;38;1;3;2399;219116;12891
Syddanmark;15-3-2021;M;88;1;6;2400;219204;12897
Hovedstaden;16-3-2021;F;121;1;8;2401;219325;12905
Midtjylland;16-3-2021;F;45;0;3;2401;219370;12908
Nordjylland;16-3-2021;F;22;0;0;2401;219392;12908
Sjælland;16-3-2021;F;41;0;3;2401;219433;12911
Syddanmark;16-3-2021;F;102;0;2;2401;219535;12913
Hovedstaden;16-3-2021;M;153;1;9;2402;219688;12922
Midtjylland;16-3-2021;M;79;0;3;2402;219767;12925
Nordjylland;16-3-2021;M;27;0;3;2402;219794;12928
Sjælland;16-3-2021;M;51;0;3;2402;219845;12931
Syddanmark;16-3-2021;M;99;0;7;2402;219944;12938
Hovedstaden;17-3-2021;F;122;0;4;2402;220066;12942
Midtjylland;17-3-2021;F;42;0;2;2402;220108;12944
Nordjylland;17-3-2021;F;17;0;0;2402;220125;12944
Sjælland;17-3-2021;F;43;0;0;2402;220168;12944
Syddanmark;17-3-2021;F;81;0;4;2402;220249;12948
Hovedstaden;17-3-2021;M;128;0;6;2402;220377;12954
Midtjylland;17-3-2021;M;44;0;0;2402;220421;12954
Nordjylland;17-3-2021;M;24;0;1;2402;220445;12955
Sjælland;17-3-2021;M;43;1;1;2403;220488;12956
Syddanmark;17-3-2021;M;115;2;3;2405;220603;12959
Hovedstaden;18-3-2021;F;148;3;4;2408;220751;12963
Midtjylland;18-3-2021;F;40;0;2;2408;220791;12965
Nordjylland;18-3-2021;F;11;0;0;2408;220802;12965
Sjælland;18-3-2021;F;39;0;2;2408;220841;12967
Syddanmark;18-3-2021;F;90;0;3;2408;220931;12970
Hovedstaden;18-3-2021;M;139;1;8;2409;221070;12978
Midtjylland;18-3-2021;M;33;0;1;2409;221103;12979
Nordjylland;18-3-2021;M;18;0;1;2409;221121;12980
Sjælland;18-3-2021;M;44;0;3;2409;221165;12983
Syddanmark;18-3-2021;M;82;1;5;2410;221247;12988
Hovedstaden;19-3-2021;F;165;0;5;2410;221412;12993
Midtjylland;19-3-2021;F;41;0;1;2410;221453;12994
Nordjylland;19-3-2021;F;10;0;1;2410;221463;12995
Sjælland;19-3-2021;F;42;1;4;2411;221505;12999
Syddanmark;19-3-2021;F;64;0;4;2411;221569;13003
Hovedstaden;19-3-2021;M;162;0;4;2411;221731;13007
Midtjylland;19-3-2021;M;32;0;0;2411;221763;13007
Nordjylland;19-3-2021;M;11;0;1;2411;221774;13008
Sjælland;19-3-2021;M;40;0;5;2411;221814;13013
Syddanmark;19-3-2021;M;72;0;2;2411;221886;13015
Hovedstaden;20-3-2021;F;121;0;3;2411;222007;13018
Midtjylland;20-3-2021;F;26;1;1;2412;222033;13019
Nordjylland;20-3-2021;F;18;0;4;2412;222051;13023
Sjælland;20-3-2021;F;24;1;2;2413;222075;13025
Syddanmark;20-3-2021;F;71;0;2;2413;222146;13027
Hovedstaden;20-3-2021;M;165;0;12;2413;222311;13039
Midtjylland;20-3-2021;M;42;0;1;2413;222353;13040
Nordjylland;20-3-2021;M;21;0;0;2413;222374;13040
Sjælland;20-3-2021;M;29;0;2;2413;222403;13042
Syddanmark;20-3-2021;M;60;0;2;2413;222463;13044
Hovedstaden;21-3-2021;F;133;0;5;2413;222596;13049
Midtjylland;21-3-2021;F;38;0;2;2413;222634;13051
Nordjylland;21-3-2021;F;16;0;1;2413;222650;13052
Sjælland;21-3-2021;F;23;0;1;2413;222673;13053
Syddanmark;21-3-2021;F;61;0;3;2413;222734;13056
Hovedstaden;21-3-2021;M;143;1;7;2414;222877;13063
Midtjylland;21-3-2021;M;45;0;2;2414;222922;13065
Nordjylland;21-3-2021;M;15;0;0;2414;222937;13065
Sjælland;21-3-2021;M;28;1;1;2415;222965;13066
Syddanmark;21-3-2021;M;59;0;4;2415;223024;13070
Hovedstaden;22-3-2021;F;172;0;8;2415;223196;13078
Midtjylland;22-3-2021;F;43;1;2;2416;223239;13080
Nordjylland;22-3-2021;F;20;0;1;2416;223259;13081
Sjælland;22-3-2021;F;39;1;3;2417;223298;13084
Syddanmark;22-3-2021;F;85;0;2;2417;223383;13086
Hovedstaden;22-3-2021;M;189;1;12;2418;223572;13098
Midtjylland;22-3-2021;M;57;0;2;2418;223629;13100
Nordjylland;22-3-2021;M;25;0;1;2418;223654;13101
Sjælland;22-3-2021;M;42;0;2;2418;223696;13103
Syddanmark;22-3-2021;M;104;0;4;2418;223800;13107
Hovedstaden;23-3-2021;F;178;0;14;2418;223978;13121
Midtjylland;23-3-2021;F;76;0;2;2418;224054;13123
Nordjylland;23-3-2021;F;11;0;1;2418;224065;13124
Sjælland;23-3-2021;F;42;0;3;2418;224107;13127
Syddanmark;23-3-2021;F;76;1;3;2419;224183;13130
Hovedstaden;23-3-2021;M;212;2;6;2421;224395;13136
Midtjylland;23-3-2021;M;52;0;4;2421;224447;13140
Nordjylland;23-3-2021;M;24;0;2;2421;224471;13142
Sjælland;23-3-2021;M;47;0;1;2421;224518;13143
Syddanmark;23-3-2021;M;83;0;3;2421;224601;13146
Hovedstaden;24-3-2021;F;203;1;6;2422;224804;13152
Midtjylland;24-3-2021;F;50;0;1;2422;224854;13153
Nordjylland;24-3-2021;F;18;0;1;2422;224872;13154
Sjælland;24-3-2021;F;38;0;3;2422;224910;13157
Syddanmark;24-3-2021;F;79;0;0;2422;224989;13157
Hovedstaden;24-3-2021;M;185;0;8;2422;225174;13165
Midtjylland;24-3-2021;M;58;1;4;2423;225232;13169
Nordjylland;24-3-2021;M;23;0;1;2423;225255;13170
Sjælland;24-3-2021;M;42;0;3;2423;225297;13173
Syddanmark;24-3-2021;M;82;0;5;2423;225379;13178
Hovedstaden;25-3-2021;F;172;1;11;2424;225551;13189
Midtjylland;25-3-2021;F;38;0;3;2424;225589;13192
Nordjylland;25-3-2021;F;8;0;1;2424;225597;13193
Sjælland;25-3-2021;F;29;0;3;2424;225626;13196
Syddanmark;25-3-2021;F;59;0;2;2424;225685;13198
Hovedstaden;25-3-2021;M;178;0;12;2424;225863;13210
Midtjylland;25-3-2021;M;40;0;0;2424;225903;13210
Nordjylland;25-3-2021;M;20;0;1;2424;225923;13211
Sjælland;25-3-2021;M;34;0;0;2424;225957;13211
Syddanmark;25-3-2021;M;57;0;3;2424;226014;13214
Hovedstaden;26-3-2021;F;172;0;10;2424;226186;13224
Midtjylland;26-3-2021;F;41;0;1;2424;226227;13225
Nordjylland;26-3-2021;F;10;0;0;2424;226237;13225
Sjælland;26-3-2021;F;36;0;0;2424;226273;13225
Syddanmark;26-3-2021;F;69;0;5;2424;226342;13230
Hovedstaden;26-3-2021;M;200;0;9;2424;226542;13239
Midtjylland;26-3-2021;M;39;0;0;2424;226581;13239
Nordjylland;26-3-2021;M;14;0;1;2424;226595;13240
Sjælland;26-3-2021;M;43;0;3;2424;226638;13243
Syddanmark;26-3-2021;M;70;0;3;2424;226708;13246
Hovedstaden;27-3-2021;F;174;0;8;2424;226882;13254
Midtjylland;27-3-2021;F;54;0;3;2424;226936;13257
Nordjylland;27-3-2021;F;16;0;0;2424;226952;13257
Sjælland;27-3-2021;F;33;0;3;2424;226985;13260
Syddanmark;27-3-2021;F;72;0;4;2424;227057;13264
Hovedstaden;27-3-2021;M;162;2;15;2426;227219;13279
Midtjylland;27-3-2021;M;47;1;4;2427;227266;13283
Nordjylland;27-3-2021;M;20;0;3;2427;227286;13286
Sjælland;27-3-2021;M;45;0;10;2427;227331;13296
Syddanmark;27-3-2021;M;46;0;1;2427;227377;13297
Hovedstaden;28-3-2021;F;158;1;6;2428;227535;13303
Midtjylland;28-3-2021;F;39;1;5;2429;227574;13308
Nordjylland;28-3-2021;F;11;0;2;2429;227585;13310
Sjælland;28-3-2021;F;25;0;1;2429;227610;13311
Syddanmark;28-3-2021;F;63;1;1;2430;227673;13312
Hovedstaden;28-3-2021;M;164;0;4;2430;227837;13316
Midtjylland;28-3-2021;M;37;0;3;2430;227874;13319
Nordjylland;28-3-2021;M;14;0;0;2430;227888;13319
Sjælland;28-3-2021;M;38;0;3;2430;227926;13322
Syddanmark;28-3-2021;M;61;0;2;2430;227987;13324
Hovedstaden;29-3-2021;F;197;2;15;2432;228184;13339
Midtjylland;29-3-2021;F;55;0;1;2432;228239;13340
Nordjylland;29-3-2021;F;14;0;1;2432;228253;13341
Sjælland;29-3-2021;F;47;1;1;2433;228300;13342
Syddanmark;29-3-2021;F;74;0;6;2433;228374;13348
Hovedstaden;29-3-2021;M;207;3;20;2436;228581;13368
Midtjylland;29-3-2021;M;42;0;3;2436;228623;13371
Nordjylland;29-3-2021;M;26;0;0;2436;228649;13371
Sjælland;29-3-2021;M;42;0;3;2436;228691;13374
Syddanmark;29-3-2021;M;59;0;3;2436;228750;13377
Hovedstaden;30-3-2021;F;193;2;14;2438;228943;13391
Midtjylland;30-3-2021;F;48;1;5;2439;228991;13396
Nordjylland;30-3-2021;F;20;0;3;2439;229011;13399
Sjælland;30-3-2021;F;31;0;2;2439;229042;13401
Syddanmark;30-3-2021;F;60;0;2;2439;229102;13403
Hovedstaden;30-3-2021;M;173;1;13;2440;229275;13416
Midtjylland;30-3-2021;M;44;0;2;2440;229319;13418
Nordjylland;30-3-2021;M;21;0;1;2440;229340;13419
Sjælland;30-3-2021;M;32;0;1;2440;229372;13420
Syddanmark;30-3-2021;M;46;0;0;2440;229418;13420
Hovedstaden;31-3-2021;F;174;0;8;2440;229592;13428
Midtjylland;31-3-2021;F;47;2;1;2442;229639;13429
Nordjylland;31-3-2021;F;21;0;0;2442;229660;13429
Sjælland;31-3-2021;F;24;2;6;2444;229684;13435
Syddanmark;31-3-2021;F;50;0;2;2444;229734;13437
Hovedstaden;31-3-2021;M;197;1;12;2445;229931;13449
Midtjylland;31-3-2021;M;53;0;6;2445;229984;13455
Nordjylland;31-3-2021;M;29;0;0;2445;230013;13455
Sjælland;31-3-2021;M;34;0;1;2445;230047;13456
Syddanmark;31-3-2021;M;56;1;3;2446;230103;13459
Hovedstaden;1-4-2021;F;180;1;8;2447;230283;13467
Midtjylland;1-4-2021;F;57;0;4;2447;230340;13471
Nordjylland;1-4-2021;F;22;0;1;2447;230362;13472
Sjælland;1-4-2021;F;46;0;1;2447;230408;13473
Syddanmark;1-4-2021;F;64;0;1;2447;230472;13474
Hovedstaden;1-4-2021;M;174;0;12;2447;230646;13486
Midtjylland;1-4-2021;M;52;0;7;2447;230698;13493
Nordjylland;1-4-2021;M;24;0;0;2447;230722;13493
Sjælland;1-4-2021;M;44;0;0;2447;230766;13493
Syddanmark;1-4-2021;M;42;0;5;2447;230808;13498
Hovedstaden;2-4-2021;F;147;0;5;2447;230955;13503
Midtjylland;2-4-2021;F;45;0;1;2447;231000;13504
Nordjylland;2-4-2021;F;18;0;0;2447;231018;13504
Sjælland;2-4-2021;F;30;0;1;2447;231048;13505
Syddanmark;2-4-2021;F;40;0;1;2447;231088;13506
Hovedstaden;2-4-2021;M;126;0;8;2447;231214;13514
Midtjylland;2-4-2021;M;45;0;1;2447;231259;13515
Nordjylland;2-4-2021;M;18;0;2;2447;231277;13517
Sjælland;2-4-2021;M;33;0;3;2447;231310;13520
Syddanmark;2-4-2021;M;47;0;2;2447;231357;13522
Hovedstaden;3-4-2021;F;115;0;3;2447;231472;13525
Midtjylland;3-4-2021;F;59;0;3;2447;231531;13528
Nordjylland;3-4-2021;F;13;0;0;2447;231544;13528
Sjælland;3-4-2021;F;26;0;2;2447;231570;13530
Syddanmark;3-4-2021;F;43;0;1;2447;231613;13531
Hovedstaden;3-4-2021;M;124;1;8;2448;231737;13539
Midtjylland;3-4-2021;M;50;1;2;2449;231787;13541
Nordjylland;3-4-2021;M;26;0;1;2449;231813;13542
Sjælland;3-4-2021;M;30;0;0;2449;231843;13542
Syddanmark;3-4-2021;M;30;0;1;2449;231873;13543
Hovedstaden;4-4-2021;F;124;0;7;2449;231997;13550
Midtjylland;4-4-2021;F;34;0;0;2449;232031;13550
Nordjylland;4-4-2021;F;16;0;0;2449;232047;13550
Sjælland;4-4-2021;F;16;0;2;2449;232063;13552
Syddanmark;4-4-2021;F;35;0;4;2449;232098;13556
Hovedstaden;4-4-2021;M;116;0;3;2449;232214;13559
Midtjylland;4-4-2021;M;41;0;1;2449;232255;13560
Nordjylland;4-4-2021;M;26;0;1;2449;232281;13561
Sjælland;4-4-2021;M;25;0;0;2449;232306;13561
Syddanmark;4-4-2021;M;26;0;0;2449;232332;13561
Hovedstaden;5-4-2021;F;130;0;3;2449;232462;13564
Midtjylland;5-4-2021;F;50;0;1;2449;232512;13565
Nordjylland;5-4-2021;F;25;0;2;2449;232537;13567
Sjælland;5-4-2021;F;30;0;1;2449;232567;13568
Syddanmark;5-4-2021;F;40;0;1;2449;232607;13569
Hovedstaden;5-4-2021;M;139;0;5;2449;232746;13574
Midtjylland;5-4-2021;M;38;0;2;2449;232784;13576
Nordjylland;5-4-2021;M;25;0;1;2449;232809;13577
Sjælland;5-4-2021;M;33;0;1;2449;232842;13578
Syddanmark;5-4-2021;M;41;0;4;2449;232883;13582
Hovedstaden;6-4-2021;F;174;0;8;2449;233057;13590
Midtjylland;6-4-2021;F;39;0;2;2449;233096;13592
Nordjylland;6-4-2021;F;21;0;1;2449;233117;13593
Sjælland;6-4-2021;F;34;0;3;2449;233151;13596
Syddanmark;6-4-2021;F;54;0;5;2449;233205;13601
Hovedstaden;6-4-2021;M;199;0;11;2449;233404;13612
Midtjylland;6-4-2021;M;58;0;5;2449;233462;13617
Nordjylland;6-4-2021;M;31;0;0;2449;233493;13617
Sjælland;6-4-2021;M;30;0;1;2449;233523;13618
Syddanmark;6-4-2021;M;55;0;2;2449;233578;13620
Hovedstaden;7-4-2021;F;147;1;6;2450;233725;13626
Midtjylland;7-4-2021;F;54;0;3;2450;233779;13629
Nordjylland;7-4-2021;F;38;0;2;2450;233817;13631
Sjælland;7-4-2021;F;34;0;3;2450;233851;13634
Syddanmark;7-4-2021;F;57;0;2;2450;233908;13636
Hovedstaden;7-4-2021;M;178;2;6;2452;234086;13642
Midtjylland;7-4-2021;M;54;0;2;2452;234140;13644
Nordjylland;7-4-2021;M;30;0;1;2452;234170;13645
Sjælland;7-4-2021;M;50;0;5;2452;234220;13650
Syddanmark;7-4-2021;M;62;0;4;2452;234282;13654
Hovedstaden;8-4-2021;F;181;1;7;2453;234463;13661
Midtjylland;8-4-2021;F;67;1;3;2454;234530;13664
Nordjylland;8-4-2021;F;11;0;0;2454;234541;13664
Sjælland;8-4-2021;F;46;0;2;2454;234587;13666
Syddanmark;8-4-2021;F;39;1;1;2455;234626;13667
Hovedstaden;8-4-2021;M;175;0;7;2455;234801;13674
Midtjylland;8-4-2021;M;59;1;3;2456;234860;13677
Nordjylland;8-4-2021;M;28;1;3;2457;234888;13680
Sjælland;8-4-2021;M;51;0;4;2457;234939;13684
Syddanmark;8-4-2021;M;49;0;6;2457;234988;13690
Hovedstaden;9-4-2021;F;177;2;10;2459;235165;13700
Midtjylland;9-4-2021;F;44;0;3;2459;235209;13703
Nordjylland;9-4-2021;F;26;2;3;2461;235235;13706
Sjælland;9-4-2021;F;44;0;2;2461;235279;13708
Syddanmark;9-4-2021;F;47;0;0;2461;235326;13708
Hovedstaden;9-4-2021;M;192;1;7;2462;235518;13715
Midtjylland;9-4-2021;M;49;0;3;2462;235567;13718
Nordjylland;9-4-2021;M;28;0;1;2462;235595;13719
Sjælland;9-4-2021;M;47;0;1;2462;235642;13720
Syddanmark;9-4-2021;M;61;0;1;2462;235703;13721
Hovedstaden;10-4-2021;F;127;0;5;2462;235830;13726
Midtjylland;10-4-2021;F;33;0;5;2462;235863;13731
Nordjylland;10-4-2021;F;26;0;1;2462;235889;13732
Sjælland;10-4-2021;F;26;0;0;2462;235915;13732
Syddanmark;10-4-2021;F;47;0;1;2462;235962;13733
Hovedstaden;10-4-2021;M;132;1;3;2463;236094;13736
Midtjylland;10-4-2021;M;42;0;1;2463;236136;13737
Nordjylland;10-4-2021;M;32;0;0;2463;236168;13737
Sjælland;10-4-2021;M;31;0;2;2463;236199;13739
Syddanmark;10-4-2021;M;46;1;4;2464;236245;13743
Hovedstaden;11-4-2021;F;122;0;3;2464;236367;13746
Midtjylland;11-4-2021;F;55;1;2;2465;236422;13748
Nordjylland;11-4-2021;F;18;0;0;2465;236440;13748
Sjælland;11-4-2021;F;30;0;2;2465;236470;13750
Syddanmark;11-4-2021;F;30;0;5;2465;236500;13755
Hovedstaden;11-4-2021;M;115;0;4;2465;236615;13759
Midtjylland;11-4-2021;M;42;0;0;2465;236657;13759
Nordjylland;11-4-2021;M;23;0;0;2465;236680;13759
Sjælland;11-4-2021;M;44;0;2;2465;236724;13761
Syddanmark;11-4-2021;M;49;1;3;2466;236773;13764
Hovedstaden;12-4-2021;F;163;0;15;2466;236936;13779
Midtjylland;12-4-2021;F;45;0;3;2466;236981;13782
Nordjylland;12-4-2021;F;37;2;3;2468;237018;13785
Sjælland;12-4-2021;F;49;0;2;2468;237067;13787
Syddanmark;12-4-2021;F;55;0;4;2468;237122;13791
Hovedstaden;12-4-2021;M;197;3;13;2471;237319;13804
Midtjylland;12-4-2021;M;62;0;2;2471;237381;13806
Nordjylland;12-4-2021;M;31;0;1;2471;237412;13807
Sjælland;12-4-2021;M;57;0;4;2471;237469;13811
Syddanmark;12-4-2021;M;51;0;0;2471;237520;13811
Hovedstaden;13-4-2021;F;151;2;8;2473;237671;13819
Midtjylland;13-4-2021;F;66;0;2;2473;237737;13821
Nordjylland;13-4-2021;F;21;0;1;2473;237758;13822
Sjælland;13-4-2021;F;58;0;0;2473;237816;13822
Syddanmark;13-4-2021;F;42;0;2;2473;237858;13824
Hovedstaden;13-4-2021;M;181;0;10;2473;238039;13834
Midtjylland;13-4-2021;M;85;0;2;2473;238124;13836
Nordjylland;13-4-2021;M;33;0;1;2473;238157;13837
Sjælland;13-4-2021;M;42;0;2;2473;238199;13839
Syddanmark;13-4-2021;M;54;0;1;2473;238253;13840
Hovedstaden;14-4-2021;F;168;0;6;2473;238421;13846
Midtjylland;14-4-2021;F;53;0;2;2473;238474;13848
Nordjylland;14-4-2021;F;24;0;0;2473;238498;13848
Sjælland;14-4-2021;F;34;0;1;2473;238532;13849
Syddanmark;14-4-2021;F;37;0;1;2473;238569;13850
Hovedstaden;14-4-2021;M;165;0;9;2473;238734;13859
Midtjylland;14-4-2021;M;82;1;4;2474;238816;13863
Nordjylland;14-4-2021;M;30;0;0;2474;238846;13863
Sjælland;14-4-2021;M;41;0;5;2474;238887;13868
Syddanmark;14-4-2021;M;56;0;3;2474;238943;13871
Hovedstaden;15-4-2021;F;178;1;6;2475;239121;13877
Midtjylland;15-4-2021;F;84;0;2;2475;239205;13879
Nordjylland;15-4-2021;F;25;0;1;2475;239230;13880
Sjælland;15-4-2021;F;47;0;3;2475;239277;13883
Syddanmark;15-4-2021;F;52;0;4;2475;239329;13887
Hovedstaden;15-4-2021;M;147;2;7;2477;239476;13894
Midtjylland;15-4-2021;M;71;0;7;2477;239547;13901
Nordjylland;15-4-2021;M;24;0;0;2477;239571;13901
Sjælland;15-4-2021;M;42;0;3;2477;239613;13904
Syddanmark;15-4-2021;M;55;0;1;2477;239668;13905
Hovedstaden;16-4-2021;F;160;0;10;2477;239828;13915
Midtjylland;16-4-2021;F;57;0;3;2477;239885;13918
Nordjylland;16-4-2021;F;19;0;0;2477;239904;13918
Sjælland;16-4-2021;F;43;0;1;2477;239947;13919
Syddanmark;16-4-2021;F;42;0;1;2477;239989;13920
Hovedstaden;16-4-2021;M;171;0;4;2477;240160;13924
Midtjylland;16-4-2021;M;86;0;0;2477;240246;13924
Nordjylland;16-4-2021;M;25;0;1;2477;240271;13925
Sjælland;16-4-2021;M;43;1;4;2478;240314;13929
Syddanmark;16-4-2021;M;54;0;1;2478;240368;13930
Hovedstaden;17-4-2021;F;146;0;4;2478;240514;13934
Midtjylland;17-4-2021;F;72;0;6;2478;240586;13940
Nordjylland;17-4-2021;F;29;0;0;2478;240615;13940
Sjælland;17-4-2021;F;36;0;0;2478;240651;13940
Syddanmark;17-4-2021;F;35;0;1;2478;240686;13941
Hovedstaden;17-4-2021;M;161;0;8;2478;240847;13949
Midtjylland;17-4-2021;M;64;0;2;2478;240911;13951
Nordjylland;17-4-2021;M;27;1;0;2479;240938;13951
Sjælland;17-4-2021;M;34;0;1;2479;240972;13952
Syddanmark;17-4-2021;M;43;0;3;2479;241015;13955
Hovedstaden;18-4-2021;F;176;2;10;2481;241191;13965
Midtjylland;18-4-2021;F;76;0;6;2481;241267;13971
Nordjylland;18-4-2021;F;32;0;1;2481;241299;13972
Sjælland;18-4-2021;F;37;0;4;2481;241336;13976
Syddanmark;18-4-2021;F;37;0;4;2481;241373;13980
Hovedstaden;18-4-2021;M;175;0;9;2481;241548;13989
Midtjylland;18-4-2021;M;75;0;0;2481;241623;13989
Nordjylland;18-4-2021;M;18;0;0;2481;241641;13989
Sjælland;18-4-2021;M;41;0;3;2481;241682;13992
Syddanmark;18-4-2021;M;42;0;2;2481;241724;13994
Hovedstaden;19-4-2021;F;197;0;6;2481;241921;14000
Midtjylland;19-4-2021;F;81;0;2;2481;242002;14002
Nordjylland;19-4-2021;F;42;0;1;2481;242044;14003
Sjælland;19-4-2021;F;42;0;2;2481;242086;14005
Syddanmark;19-4-2021;F;53;0;3;2481;242139;14008
Hovedstaden;19-4-2021;M;181;1;10;2482;242320;14018
Midtjylland;19-4-2021;M;100;0;3;2482;242420;14021
Nordjylland;19-4-2021;M;47;1;2;2483;242467;14023
Sjælland;19-4-2021;M;60;0;6;2483;242527;14029
Syddanmark;19-4-2021;M;54;0;3;2483;242581;14032
Hovedstaden;20-4-2021;F;177;0;5;2483;242758;14037
Midtjylland;20-4-2021;F;87;0;7;2483;242845;14044
Nordjylland;20-4-2021;F;28;0;0;2483;242873;14044
Sjælland;20-4-2021;F;47;0;0;2483;242920;14044
Syddanmark;20-4-2021;F;41;0;0;2483;242961;14044
Hovedstaden;20-4-2021;M;181;0;9;2483;243142;14053
Midtjylland;20-4-2021;M;109;0;5;2483;243251;14058
Nordjylland;20-4-2021;M;54;0;2;2483;243305;14060
Sjælland;20-4-2021;M;52;1;4;2484;243357;14064
Syddanmark;20-4-2021;M;62;0;0;2484;243419;14064
Hovedstaden;21-4-2021;F;156;0;6;2484;243575;14070
Midtjylland;21-4-2021;F;63;0;0;2484;243638;14070
Nordjylland;21-4-2021;F;21;0;1;2484;243659;14071
Sjælland;21-4-2021;F;39;0;1;2484;243698;14072
Syddanmark;21-4-2021;F;34;0;2;2484;243732;14074
Hovedstaden;21-4-2021;M;159;1;9;2485;243891;14083
Midtjylland;21-4-2021;M;81;0;3;2485;243972;14086
Nordjylland;21-4-2021;M;18;0;1;2485;243990;14087
Sjælland;21-4-2021;M;47;0;2;2485;244037;14089
Syddanmark;21-4-2021;M;38;0;0;2485;244075;14089
Hovedstaden;22-4-2021;F;141;1;8;2486;244216;14097
Midtjylland;22-4-2021;F;52;0;0;2486;244268;14097
Nordjylland;22-4-2021;F;25;0;0;2486;244293;14097
Sjælland;22-4-2021;F;34;0;3;2486;244327;14100
Syddanmark;22-4-2021;F;34;0;0;2486;244361;14100
Hovedstaden;22-4-2021;M;147;0;3;2486;244508;14103
Midtjylland;22-4-2021;M;52;0;2;2486;244560;14105
Nordjylland;22-4-2021;M;26;0;1;2486;244586;14106
Sjælland;22-4-2021;M;50;0;3;2486;244636;14109
Syddanmark;22-4-2021;M;54;0;0;2486;244690;14109
Hovedstaden;23-4-2021;F;124;0;3;2486;244814;14112
Midtjylland;23-4-2021;F;54;0;1;2486;244868;14113
Nordjylland;23-4-2021;F;37;0;2;2486;244905;14115
Sjælland;23-4-2021;F;35;0;1;2486;244940;14116
Syddanmark;23-4-2021;F;50;0;2;2486;244990;14118
Hovedstaden;23-4-2021;M;135;1;3;2487;245125;14121
Midtjylland;23-4-2021;M;65;0;2;2487;245190;14123
Nordjylland;23-4-2021;M;42;0;0;2487;245232;14123
Sjælland;23-4-2021;M;29;0;1;2487;245261;14124
Syddanmark;23-4-2021;M;43;0;1;2487;245304;14125
Hovedstaden;24-4-2021;F;117;0;8;2487;245421;14133
Midtjylland;24-4-2021;F;62;0;2;2487;245483;14135
Nordjylland;24-4-2021;F;25;0;0;2487;245508;14135
Sjælland;24-4-2021;F;39;0;3;2487;245547;14138
Syddanmark;24-4-2021;F;26;0;1;2487;245573;14139
Hovedstaden;24-4-2021;M;112;0;6;2487;245685;14145
Midtjylland;24-4-2021;M;69;1;4;2488;245754;14149
Nordjylland;24-4-2021;M;36;0;0;2488;245790;14149
Sjælland;24-4-2021;M;28;0;1;2488;245818;14150
Syddanmark;24-4-2021;M;49;0;1;2488;245867;14151
Hovedstaden;25-4-2021;F;151;0;7;2488;246018;14158
Midtjylland;25-4-2021;F;53;0;1;2488;246071;14159
Nordjylland;25-4-2021;F;34;0;2;2488;246105;14161
Sjælland;25-4-2021;F;38;0;3;2488;246143;14164
Syddanmark;25-4-2021;F;35;0;3;2488;246178;14167
Hovedstaden;25-4-2021;M;121;0;5;2488;246299;14172
Midtjylland;25-4-2021;M;65;0;4;2488;246364;14176
Nordjylland;25-4-2021;M;30;0;0;2488;246394;14176
Sjælland;25-4-2021;M;26;0;1;2488;246420;14177
Syddanmark;25-4-2021;M;40;0;1;2488;246460;14178
Hovedstaden;26-4-2021;F;163;0;5;2488;246623;14183
Midtjylland;26-4-2021;F;60;0;2;2488;246683;14185
Nordjylland;26-4-2021;F;29;0;3;2488;246712;14188
Sjælland;26-4-2021;F;45;1;3;2489;246757;14191
Syddanmark;26-4-2021;F;39;0;3;2489;246796;14194
Hovedstaden;26-4-2021;M;183;0;10;2489;246979;14204
Midtjylland;26-4-2021;M;70;0;5;2489;247049;14209
Nordjylland;26-4-2021;M;45;1;6;2490;247094;14215
Sjælland;26-4-2021;M;56;0;3;2490;247150;14218
Syddanmark;26-4-2021;M;72;0;3;2490;247222;14221
Hovedstaden;27-4-2021;F;215;0;12;2490;247437;14233
Midtjylland;27-4-2021;F;62;0;2;2490;247499;14235
Nordjylland;27-4-2021;F;43;0;4;2490;247542;14239
Sjælland;27-4-2021;F;44;0;0;2490;247586;14239
Syddanmark;27-4-2021;F;61;0;1;2490;247647;14240
Hovedstaden;27-4-2021;M;216;0;2;2490;247863;14242
Midtjylland;27-4-2021;M;85;0;3;2490;247948;14245
Nordjylland;27-4-2021;M;32;0;0;2490;247980;14245
Sjælland;27-4-2021;M;51;0;3;2490;248031;14248
Syddanmark;27-4-2021;M;77;0;2;2490;248108;14250
Hovedstaden;28-4-2021;F;207;0;13;2490;248315;14263
Midtjylland;28-4-2021;F;69;0;2;2490;248384;14265
Nordjylland;28-4-2021;F;31;0;1;2490;248415;14266
Sjælland;28-4-2021;F;50;0;5;2490;248465;14271
Syddanmark;28-4-2021;F;49;0;2;2490;248514;14273
Hovedstaden;28-4-2021;M;186;0;6;2490;248700;14279
Midtjylland;28-4-2021;M;77;0;3;2490;248777;14282
Nordjylland;28-4-2021;M;34;0;1;2490;248811;14283
Sjælland;28-4-2021;M;42;0;1;2490;248853;14284
Syddanmark;28-4-2021;M;59;0;2;2490;248912;14286
Hovedstaden;29-4-2021;F;181;0;6;2490;249093;14292
Midtjylland;29-4-2021;F;66;0;5;2490;249159;14297
Nordjylland;29-4-2021;F;24;0;0;2490;249183;14297
Sjælland;29-4-2021;F;45;0;2;2490;249228;14299
Syddanmark;29-4-2021;F;55;0;4;2490;249283;14303
Hovedstaden;29-4-2021;M;196;0;9;2490;249479;14312
Midtjylland;29-4-2021;M;80;0;3;2490;249559;14315
Nordjylland;29-4-2021;M;35;0;2;2490;249594;14317
Sjælland;29-4-2021;M;53;0;1;2490;249647;14318
Syddanmark;29-4-2021;M;57;0;0;2490;249704;14318
Hovedstaden;30-4-2021;F;178;0;6;2490;249882;14324
Midtjylland;30-4-2021;F;58;0;1;2490;249940;14325
Nordjylland;30-4-2021;F;29;0;0;2490;249969;14325
Sjælland;30-4-2021;F;31;0;1;2490;250000;14326
Syddanmark;30-4-2021;F;54;0;2;2490;250054;14328
Hovedstaden;30-4-2021;M;189;0;7;2490;250243;14335
Midtjylland;30-4-2021;M;71;0;4;2490;250314;14339
Nordjylland;30-4-2021;M;35;1;3;2491;250349;14342
Sjælland;30-4-2021;M;38;0;1;2491;250387;14343
Syddanmark;30-4-2021;M;71;0;3;2491;250458;14346
Hovedstaden;1-5-2021;F;149;0;13;2491;250607;14359
Midtjylland;1-5-2021;F;74;0;2;2491;250681;14361
Nordjylland;1-5-2021;F;32;0;3;2491;250713;14364
Sjælland;1-5-2021;F;26;0;1;2491;250739;14365
Syddanmark;1-5-2021;F;48;0;1;2491;250787;14366
Hovedstaden;1-5-2021;M;152;1;7;2492;250939;14373
Midtjylland;1-5-2021;M;85;0;3;2492;251024;14376
Nordjylland;1-5-2021;M;32;0;2;2492;251056;14378
Sjælland;1-5-2021;M;42;0;2;2492;251098;14380
Syddanmark;1-5-2021;M;47;0;1;2492;251145;14381
Hovedstaden;2-5-2021;F;180;0;7;2492;251325;14388
Midtjylland;2-5-2021;F;65;0;3;2492;251390;14391
Nordjylland;2-5-2021;F;33;0;2;2492;251423;14393
Sjælland;2-5-2021;F;25;0;2;2492;251448;14395
Syddanmark;2-5-2021;F;44;0;1;2492;251492;14396
Hovedstaden;2-5-2021;M;174;0;9;2492;251666;14405
Midtjylland;2-5-2021;M;70;0;3;2492;251736;14408
Nordjylland;2-5-2021;M;26;0;1;2492;251762;14409
Sjælland;2-5-2021;M;30;0;2;2492;251792;14411
Syddanmark;2-5-2021;M;60;0;0;2492;251852;14411
Hovedstaden;3-5-2021;F;213;0;8;2492;252065;14419
Midtjylland;3-5-2021;F;98;1;4;2493;252163;14423
Nordjylland;3-5-2021;F;30;0;1;2493;252193;14424
Sjælland;3-5-2021;F;71;0;2;2493;252264;14426
Syddanmark;3-5-2021;F;58;0;1;2493;252322;14427
Hovedstaden;3-5-2021;M;276;0;8;2493;252598;14435
Midtjylland;3-5-2021;M;92;0;2;2493;252690;14437
Nordjylland;3-5-2021;M;43;0;2;2493;252733;14439
Sjælland;3-5-2021;M;64;0;2;2493;252797;14441
Syddanmark;3-5-2021;M;70;0;1;2493;252867;14442
Hovedstaden;4-5-2021;F;248;0;5;2493;253115;14447
Midtjylland;4-5-2021;F;91;0;4;2493;253206;14451
Nordjylland;4-5-2021;F;25;0;0;2493;253231;14451
Sjælland;4-5-2021;F;61;1;4;2494;253292;14455
Syddanmark;4-5-2021;F;58;0;0;2494;253350;14455
Hovedstaden;4-5-2021;M;212;0;5;2494;253562;14460
Midtjylland;4-5-2021;M;105;0;4;2494;253667;14464
Nordjylland;4-5-2021;M;33;0;1;2494;253700;14465
Sjælland;4-5-2021;M;56;0;7;2494;253756;14472
Syddanmark;4-5-2021;M;75;0;2;2494;253831;14474
Hovedstaden;5-5-2021;F;260;1;11;2495;254091;14485
Midtjylland;5-5-2021;F;93;0;2;2495;254184;14487
Nordjylland;5-5-2021;F;43;0;2;2495;254227;14489
Sjælland;5-5-2021;F;59;0;2;2495;254286;14491
Syddanmark;5-5-2021;F;72;0;2;2495;254358;14493
Hovedstaden;5-5-2021;M;247;1;9;2496;254605;14502
Midtjylland;5-5-2021;M;106;0;2;2496;254711;14504
Nordjylland;5-5-2021;M;43;0;1;2496;254754;14505
Sjælland;5-5-2021;M;63;0;6;2496;254817;14511
Syddanmark;5-5-2021;M;63;0;1;2496;254880;14512
Hovedstaden;6-5-2021;F;216;1;4;2497;255096;14516
Midtjylland;6-5-2021;F;70;0;3;2497;255166;14519
Nordjylland;6-5-2021;F;25;0;1;2497;255191;14520
Sjælland;6-5-2021;F;69;0;6;2497;255260;14526
Syddanmark;6-5-2021;F;39;0;1;2497;255299;14527
Hovedstaden;6-5-2021;M;223;0;5;2497;255522;14532
Midtjylland;6-5-2021;M;83;0;2;2497;255605;14534
Nordjylland;6-5-2021;M;31;0;2;2497;255636;14536
Sjælland;6-5-2021;M;76;0;4;2497;255712;14540
Syddanmark;6-5-2021;M;47;0;1;2497;255759;14541
Hovedstaden;7-5-2021;F;209;0;10;2497;255968;14551
Midtjylland;7-5-2021;F;79;0;1;2497;256047;14552
Nordjylland;7-5-2021;F;22;0;1;2497;256069;14553
Sjælland;7-5-2021;F;54;0;2;2497;256123;14555
Syddanmark;7-5-2021;F;58;0;1;2497;256181;14556
Hovedstaden;7-5-2021;M;210;0;12;2497;256391;14568
Midtjylland;7-5-2021;M;96;0;0;2497;256487;14568
Nordjylland;7-5-2021;M;39;1;4;2498;256526;14572
Sjælland;7-5-2021;M;59;0;1;2498;256585;14573
Syddanmark;7-5-2021;M;69;0;1;2498;256654;14574
Hovedstaden;8-5-2021;F;199;0;9;2498;256853;14583
Midtjylland;8-5-2021;F;91;0;4;2498;256944;14587
Nordjylland;8-5-2021;F;24;0;0;2498;256968;14587
Sjælland;8-5-2021;F;47;0;0;2498;257015;14587
Syddanmark;8-5-2021;F;41;0;0;2498;257056;14587
Hovedstaden;8-5-2021;M;239;0;14;2498;257295;14601
Midtjylland;8-5-2021;M;86;0;1;2498;257381;14602
Nordjylland;8-5-2021;M;40;0;1;2498;257421;14603
Sjælland;8-5-2021;M;37;0;0;2498;257458;14603
Syddanmark;8-5-2021;M;42;0;2;2498;257500;14605
Hovedstaden;9-5-2021;F;190;0;7;2498;257690;14612
Midtjylland;9-5-2021;F;61;0;0;2498;257751;14612
Nordjylland;9-5-2021;F;37;0;1;2498;257788;14613
Sjælland;9-5-2021;F;53;0;1;2498;257841;14614
Syddanmark;9-5-2021;F;38;0;4;2498;257879;14618
Hovedstaden;9-5-2021;M;200;0;5;2498;258079;14623
Midtjylland;9-5-2021;M;90;0;2;2498;258169;14625
Nordjylland;9-5-2021;M;36;0;0;2498;258205;14625
Sjælland;9-5-2021;M;45;0;0;2498;258250;14625
Syddanmark;9-5-2021;M;44;0;1;2498;258294;14626
Hovedstaden;10-5-2021;F;236;1;13;2499;258530;14639
Midtjylland;10-5-2021;F;135;0;2;2499;258665;14641
Nordjylland;10-5-2021;F;28;0;1;2499;258693;14642
Sjælland;10-5-2021;F;81;0;2;2499;258774;14644
Syddanmark;10-5-2021;F;53;0;1;2499;258827;14645
Hovedstaden;10-5-2021;M;232;1;5;2500;259059;14650
Midtjylland;10-5-2021;M;147;0;3;2500;259206;14653
Nordjylland;10-5-2021;M;45;0;1;2500;259251;14654
Sjælland;10-5-2021;M;102;0;6;2500;259353;14660
Syddanmark;10-5-2021;M;63;0;1;2500;259416;14661
Hovedstaden;11-5-2021;F;281;0;7;2500;259697;14668
Midtjylland;11-5-2021;F;125;1;3;2501;259822;14671
Nordjylland;11-5-2021;F;52;0;1;2501;259874;14672
Sjælland;11-5-2021;F;77;0;3;2501;259951;14675
Syddanmark;11-5-2021;F;53;0;0;2501;260004;14675
Hovedstaden;11-5-2021;M;333;0;7;2501;260337;14682
Midtjylland;11-5-2021;M;140;0;3;2501;260477;14685
Nordjylland;11-5-2021;M;64;0;2;2501;260541;14687
Sjælland;11-5-2021;M;89;0;3;2501;260630;14690
Syddanmark;11-5-2021;M;76;0;3;2501;260706;14693
Hovedstaden;12-5-2021;F;235;1;11;2502;260941;14704
Midtjylland;12-5-2021;F;109;0;2;2502;261050;14706
Nordjylland;12-5-2021;F;46;0;1;2502;261096;14707
Sjælland;12-5-2021;F;84;0;3;2502;261180;14710
Syddanmark;12-5-2021;F;44;0;5;2502;261224;14715
Hovedstaden;12-5-2021;M;321;1;8;2503;261545;14723
Midtjylland;12-5-2021;M;95;0;2;2503;261640;14725
Nordjylland;12-5-2021;M;56;0;0;2503;261696;14725
Sjælland;12-5-2021;M;103;0;3;2503;261799;14728
Syddanmark;12-5-2021;M;56;1;4;2504;261855;14732
Hovedstaden;13-5-2021;F;211;0;7;2504;262066;14739
Midtjylland;13-5-2021;F;77;0;4;2504;262143;14743
Nordjylland;13-5-2021;F;36;0;2;2504;262179;14745
Sjælland;13-5-2021;F;55;0;3;2504;262234;14748
Syddanmark;13-5-2021;F;43;0;1;2504;262277;14749
Hovedstaden;13-5-2021;M;227;0;6;2504;262504;14755
Midtjylland;13-5-2021;M;74;0;1;2504;262578;14756
Nordjylland;13-5-2021;M;66;0;1;2504;262644;14757
Sjælland;13-5-2021;M;64;0;2;2504;262708;14759
Syddanmark;13-5-2021;M;47;1;2;2505;262755;14761
Hovedstaden;14-5-2021;F;186;0;4;2505;262941;14765
Midtjylland;14-5-2021;F;83;0;1;2505;263024;14766
Nordjylland;14-5-2021;F;43;0;1;2505;263067;14767
Sjælland;14-5-2021;F;78;0;3;2505;263145;14770
Syddanmark;14-5-2021;F;43;0;2;2505;263188;14772
Hovedstaden;14-5-2021;M;208;1;5;2506;263396;14777
Midtjylland;14-5-2021;M;79;0;3;2506;263475;14780
Nordjylland;14-5-2021;M;34;0;1;2506;263509;14781
Sjælland;14-5-2021;M;57;0;4;2506;263566;14785
Syddanmark;14-5-2021;M;54;0;2;2506;263620;14787
Hovedstaden;15-5-2021;F;217;0;9;2506;263837;14796
Midtjylland;15-5-2021;F;83;0;3;2506;263920;14799
Nordjylland;15-5-2021;F;43;0;1;2506;263963;14800
Sjælland;15-5-2021;F;68;1;3;2507;264031;14803
Syddanmark;15-5-2021;F;54;0;4;2507;264085;14807
Hovedstaden;15-5-2021;M;198;0;4;2507;264283;14811
Midtjylland;15-5-2021;M;109;0;5;2507;264392;14816
Nordjylland;15-5-2021;M;54;0;0;2507;264446;14816
Sjælland;15-5-2021;M;65;0;2;2507;264511;14818
Syddanmark;15-5-2021;M;47;0;2;2507;264558;14820
Hovedstaden;16-5-2021;F;210;0;4;2507;264768;14824
Midtjylland;16-5-2021;F;65;0;2;2507;264833;14826
Nordjylland;16-5-2021;F;50;0;0;2507;264883;14826
Sjælland;16-5-2021;F;47;0;3;2507;264930;14829
Syddanmark;16-5-2021;F;47;0;3;2507;264977;14832
Hovedstaden;16-5-2021;M;231;0;7;2507;265208;14839
Midtjylland;16-5-2021;M;82;0;5;2507;265290;14844
Nordjylland;16-5-2021;M;55;0;0;2507;265345;14844
Sjælland;16-5-2021;M;77;0;2;2507;265422;14846
Syddanmark;16-5-2021;M;52;0;0;2507;265474;14846
Hovedstaden;17-5-2021;F;221;0;6;2507;265695;14852
Midtjylland;17-5-2021;F;95;0;4;2507;265790;14856
Nordjylland;17-5-2021;F;42;0;1;2507;265832;14857
Sjælland;17-5-2021;F;68;0;3;2507;265900;14860
Syddanmark;17-5-2021;F;77;0;4;2507;265977;14864
Hovedstaden;17-5-2021;M;273;0;9;2507;266250;14873
Midtjylland;17-5-2021;M;114;0;4;2507;266364;14877
Nordjylland;17-5-2021;M;67;0;0;2507;266431;14877
Sjælland;17-5-2021;M;90;0;1;2507;266521;14878
Syddanmark;17-5-2021;M;92;0;2;2507;266613;14880
Hovedstaden;18-5-2021;F;271;0;8;2507;266884;14888
Midtjylland;18-5-2021;F;84;0;0;2507;266968;14888
Nordjylland;18-5-2021;F;56;0;1;2507;267024;14889
Sjælland;18-5-2021;F;80;0;1;2507;267104;14890
Syddanmark;18-5-2021;F;70;0;5;2507;267174;14895
Hovedstaden;18-5-2021;M;271;0;6;2507;267445;14901
Midtjylland;18-5-2021;M;98;0;5;2507;267543;14906
Nordjylland;18-5-2021;M;64;0;2;2507;267607;14908
Sjælland;18-5-2021;M;79;0;1;2507;267686;14909
Syddanmark;18-5-2021;M;73;0;0;2507;267759;14909
Hovedstaden;19-5-2021;F;241;0;6;2507;268000;14915
Midtjylland;19-5-2021;F;88;0;3;2507;268088;14918
Nordjylland;19-5-2021;F;60;0;2;2507;268148;14920
Sjælland;19-5-2021;F;86;0;3;2507;268234;14923
Syddanmark;19-5-2021;F;61;0;0;2507;268295;14923
Hovedstaden;19-5-2021;M;255;0;8;2507;268550;14931
Midtjylland;19-5-2021;M;90;0;1;2507;268640;14932
Nordjylland;19-5-2021;M;66;0;0;2507;268706;14932
Sjælland;19-5-2021;M;111;0;4;2507;268817;14936
Syddanmark;19-5-2021;M;68;0;2;2507;268885;14938
Hovedstaden;20-5-2021;F;233;0;6;2507;269118;14944
Midtjylland;20-5-2021;F;64;0;0;2507;269182;14944
Nordjylland;20-5-2021;F;67;0;1;2507;269249;14945
Sjælland;20-5-2021;F;69;0;2;2507;269318;14947
Syddanmark;20-5-2021;F;61;0;0;2507;269379;14947
Hovedstaden;20-5-2021;M;218;0;7;2507;269597;14954
Midtjylland;20-5-2021;M;80;0;1;2507;269677;14955
Nordjylland;20-5-2021;M;75;0;2;2507;269752;14957
Sjælland;20-5-2021;M;86;0;4;2507;269838;14961
Syddanmark;20-5-2021;M;57;0;0;2507;269895;14961
Hovedstaden;21-5-2021;F;178;0;6;2507;270073;14967
Midtjylland;21-5-2021;F;65;0;2;2507;270138;14969
Nordjylland;21-5-2021;F;47;0;1;2507;270185;14970
Sjælland;21-5-2021;F;61;0;3;2507;270246;14973
Syddanmark;21-5-2021;F;49;0;1;2507;270295;14974
Hovedstaden;21-5-2021;M;192;1;8;2508;270487;14982
Midtjylland;21-5-2021;M;65;1;2;2509;270552;14984
Nordjylland;21-5-2021;M;38;0;1;2509;270590;14985
Sjælland;21-5-2021;M;74;0;1;2509;270664;14986
Syddanmark;21-5-2021;M;48;1;1;2510;270712;14987
Hovedstaden;22-5-2021;F;161;0;6;2510;270873;14993
Midtjylland;22-5-2021;F;84;0;2;2510;270957;14995
Nordjylland;22-5-2021;F;50;0;0;2510;271007;14995
Sjælland;22-5-2021;F;47;0;2;2510;271054;14997
Syddanmark;22-5-2021;F;55;0;0;2510;271109;14997
Hovedstaden;22-5-2021;M;165;0;8;2510;271274;15005
Midtjylland;22-5-2021;M;83;0;2;2510;271357;15007
Nordjylland;22-5-2021;M;49;0;0;2510;271406;15007
Sjælland;22-5-2021;M;36;0;3;2510;271442;15010
Syddanmark;22-5-2021;M;51;0;4;2510;271493;15014
Hovedstaden;23-5-2021;F;156;0;6;2510;271649;15020
Midtjylland;23-5-2021;F;85;0;1;2510;271734;15021
Nordjylland;23-5-2021;F;60;0;1;2510;271794;15022
Sjælland;23-5-2021;F;41;0;3;2510;271835;15025
Syddanmark;23-5-2021;F;50;0;1;2510;271885;15026
Hovedstaden;23-5-2021;M;148;0;7;2510;272033;15033
Midtjylland;23-5-2021;M;96;0;2;2510;272129;15035
Nordjylland;23-5-2021;M;53;0;0;2510;272182;15035
Sjælland;23-5-2021;M;57;0;4;2510;272239;15039
Syddanmark;23-5-2021;M;51;0;2;2510;272290;15041
Hovedstaden;24-5-2021;F;180;0;10;2510;272470;15051
Midtjylland;24-5-2021;F;82;0;0;2510;272552;15051
Nordjylland;24-5-2021;F;46;0;2;2510;272598;15053
Sjælland;24-5-2021;F;57;0;2;2510;272655;15055
Syddanmark;24-5-2021;F;50;0;1;2510;272705;15056
Hovedstaden;24-5-2021;M;176;0;4;2510;272881;15060
Midtjylland;24-5-2021;M;98;0;3;2510;272979;15063
Nordjylland;24-5-2021;M;52;1;5;2511;273031;15068
Sjælland;24-5-2021;M;63;0;0;2511;273094;15068
Syddanmark;24-5-2021;M;52;0;1;2511;273146;15069
Hovedstaden;25-5-2021;F;188;0;6;2511;273334;15075
Midtjylland;25-5-2021;F;98;0;3;2511;273432;15078
Nordjylland;25-5-2021;F;71;0;2;2511;273503;15080
Sjælland;25-5-2021;F;57;0;2;2511;273560;15082
Syddanmark;25-5-2021;F;68;0;2;2511;273628;15084
Hovedstaden;25-5-2021;M;232;0;9;2511;273860;15093
Midtjylland;25-5-2021;M;124;0;2;2511;273984;15095
Nordjylland;25-5-2021;M;81;0;2;2511;274065;15097
Sjælland;25-5-2021;M;71;0;3;2511;274136;15100
Syddanmark;25-5-2021;M;101;0;1;2511;274237;15101
Hovedstaden;26-5-2021;F;251;0;5;2511;274488;15106
Midtjylland;26-5-2021;F;82;0;2;2511;274570;15108
Nordjylland;26-5-2021;F;67;0;1;2511;274637;15109
Sjælland;26-5-2021;F;51;0;1;2511;274688;15110
Syddanmark;26-5-2021;F;68;0;3;2511;274756;15113
Hovedstaden;26-5-2021;M;292;0;4;2511;275048;15117
Midtjylland;26-5-2021;M;94;0;1;2511;275142;15118
Nordjylland;26-5-2021;M;120;0;3;2511;275262;15121
Sjælland;26-5-2021;M;77;0;1;2511;275339;15122
Syddanmark;26-5-2021;M;88;0;1;2511;275427;15123
Hovedstaden;27-5-2021;F;194;0;7;2511;275621;15130
Midtjylland;27-5-2021;F;95;0;3;2511;275716;15133
Nordjylland;27-5-2021;F;44;0;1;2511;275760;15134
Sjælland;27-5-2021;F;51;0;0;2511;275811;15134
Syddanmark;27-5-2021;F;56;0;2;2511;275867;15136
Hovedstaden;27-5-2021;M;241;0;5;2511;276108;15141
Midtjylland;27-5-2021;M;96;0;3;2511;276204;15144
Nordjylland;27-5-2021;M;62;0;2;2511;276266;15146
Sjælland;27-5-2021;M;76;0;3;2511;276342;15149
Syddanmark;27-5-2021;M;75;0;2;2511;276417;15151
Hovedstaden;28-5-2021;F;177;0;4;2511;276594;15155
Midtjylland;28-5-2021;F;78;0;1;2511;276672;15156
Nordjylland;28-5-2021;F;55;0;0;2511;276727;15156
Sjælland;28-5-2021;F;52;0;2;2511;276779;15158
Syddanmark;28-5-2021;F;66;0;1;2511;276845;15159
Hovedstaden;28-5-2021;M;193;0;4;2511;277038;15163
Midtjylland;28-5-2021;M;102;0;1;2511;277140;15164
Nordjylland;28-5-2021;M;59;0;0;2511;277199;15164
Sjælland;28-5-2021;M;60;0;0;2511;277259;15164
Syddanmark;28-5-2021;M;74;1;3;2512;277333;15167
Hovedstaden;29-5-2021;F;160;0;4;2512;277493;15171
Midtjylland;29-5-2021;F;63;0;2;2512;277556;15173
Nordjylland;29-5-2021;F;45;0;2;2512;277601;15175
Sjælland;29-5-2021;F;34;0;2;2512;277635;15177
Syddanmark;29-5-2021;F;57;0;3;2512;277692;15180
Hovedstaden;29-5-2021;M;193;1;5;2513;277885;15185
Midtjylland;29-5-2021;M;84;0;1;2513;277969;15186
Nordjylland;29-5-2021;M;65;0;0;2513;278034;15186
Sjælland;29-5-2021;M;47;0;2;2513;278081;15188
Syddanmark;29-5-2021;M;61;0;5;2513;278142;15193
Hovedstaden;30-5-2021;F;169;1;9;2514;278311;15202
Midtjylland;30-5-2021;F;75;0;0;2514;278386;15202
Nordjylland;30-5-2021;F;61;0;0;2514;278447;15202
Sjælland;30-5-2021;F;36;0;1;2514;278483;15203
Syddanmark;30-5-2021;F;51;0;2;2514;278534;15205
Hovedstaden;30-5-2021;M;166;0;5;2514;278700;15210
Midtjylland;30-5-2021;M;92;0;1;2514;278792;15211
Nordjylland;30-5-2021;M;62;0;0;2514;278854;15211
Sjælland;30-5-2021;M;46;0;0;2514;278900;15211
Syddanmark;30-5-2021;M;59;0;1;2514;278959;15212
Hovedstaden;31-5-2021;F;218;0;3;2514;279177;15215
Midtjylland;31-5-2021;F;87;0;2;2514;279264;15217
Nordjylland;31-5-2021;F;67;0;4;2514;279331;15221
Sjælland;31-5-2021;F;52;0;3;2514;279383;15224
Syddanmark;31-5-2021;F;67;0;1;2514;279450;15225
Hovedstaden;31-5-2021;M;211;0;8;2514;279661;15233
Midtjylland;31-5-2021;M;103;0;2;2514;279764;15235
Nordjylland;31-5-2021;M;85;0;1;2514;279849;15236
Sjælland;31-5-2021;M;48;0;0;2514;279897;15236
Syddanmark;31-5-2021;M;68;0;3;2514;279965;15239
Hovedstaden;1-6-2021;F;232;0;4;2514;280197;15243
Midtjylland;1-6-2021;F;100;0;3;2514;280297;15246
Nordjylland;1-6-2021;F;77;0;2;2514;280374;15248
Sjælland;1-6-2021;F;51;0;2;2514;280425;15250
Syddanmark;1-6-2021;F;70;0;1;2514;280495;15251
Hovedstaden;1-6-2021;M;265;0;2;2514;280760;15253
Midtjylland;1-6-2021;M;98;0;2;2514;280858;15255
Nordjylland;1-6-2021;M;97;0;2;2514;280955;15257
Sjælland;1-6-2021;M;50;0;6;2514;281005;15263
Syddanmark;1-6-2021;M;58;0;0;2514;281063;15263
Hovedstaden;2-6-2021;F;191;0;3;2514;281254;15266
Midtjylland;2-6-2021;F;84;0;6;2514;281338;15272
Nordjylland;2-6-2021;F;55;0;1;2514;281393;15273
Sjælland;2-6-2021;F;50;0;1;2514;281443;15274
Syddanmark;2-6-2021;F;31;0;1;2514;281474;15275
Hovedstaden;2-6-2021;M;220;1;5;2515;281694;15280
Midtjylland;2-6-2021;M;108;0;2;2515;281802;15282
Nordjylland;2-6-2021;M;85;1;3;2516;281887;15285
Sjælland;2-6-2021;M;51;0;1;2516;281938;15286
Syddanmark;2-6-2021;M;47;0;2;2516;281985;15288
Hovedstaden;3-6-2021;F;169;0;2;2516;282154;15290
Midtjylland;3-6-2021;F;66;0;1;2516;282220;15291
Nordjylland;3-6-2021;F;48;0;2;2516;282268;15293
Sjælland;3-6-2021;F;39;0;1;2516;282307;15294
Syddanmark;3-6-2021;F;29;0;0;2516;282336;15294
Hovedstaden;3-6-2021;M;178;0;1;2516;282514;15295
Midtjylland;3-6-2021;M;67;0;1;2516;282581;15296
Nordjylland;3-6-2021;M;53;0;1;2516;282634;15297
Sjælland;3-6-2021;M;63;0;2;2516;282697;15299
Syddanmark;3-6-2021;M;36;0;1;2516;282733;15300
Hovedstaden;4-6-2021;F;151;1;4;2517;282884;15304
Midtjylland;4-6-2021;F;77;0;3;2517;282961;15307
Nordjylland;4-6-2021;F;38;0;0;2517;282999;15307
Sjælland;4-6-2021;F;42;0;1;2517;283041;15308
Syddanmark;4-6-2021;F;26;0;0;2517;283067;15308
Hovedstaden;4-6-2021;M;151;0;3;2517;283218;15311
Midtjylland;4-6-2021;M;83;0;2;2517;283301;15313
Nordjylland;4-6-2021;M;45;0;1;2517;283346;15314
Sjælland;4-6-2021;M;45;0;1;2517;283391;15315
Syddanmark;4-6-2021;M;41;0;1;2517;283432;15316
Hovedstaden;5-6-2021;F;115;0;4;2517;283547;15320
Midtjylland;5-6-2021;F;73;0;1;2517;283620;15321
Nordjylland;5-6-2021;F;39;0;0;2517;283659;15321
Sjælland;5-6-2021;F;53;0;0;2517;283712;15321
Syddanmark;5-6-2021;F;14;0;0;2517;283726;15321
Hovedstaden;5-6-2021;M;122;0;4;2517;283848;15325
Midtjylland;5-6-2021;M;70;0;0;2517;283918;15325
Nordjylland;5-6-2021;M;44;0;2;2517;283962;15327
Sjælland;5-6-2021;M;49;0;1;2517;284011;15328
Syddanmark;5-6-2021;M;41;0;2;2517;284052;15330
Hovedstaden;6-6-2021;F;112;0;5;2517;284164;15335
Midtjylland;6-6-2021;F;45;0;1;2517;284209;15336
Nordjylland;6-6-2021;F;35;0;1;2517;284244;15337
Sjælland;6-6-2021;F;32;0;3;2517;284276;15340
Syddanmark;6-6-2021;F;22;0;1;2517;284298;15341
Hovedstaden;6-6-2021;M;125;0;1;2517;284423;15342
Midtjylland;6-6-2021;M;76;0;0;2517;284499;15342
Nordjylland;6-6-2021;M;41;0;0;2517;284540;15342
Sjælland;6-6-2021;M;32;0;0;2517;284572;15342
Syddanmark;6-6-2021;M;20;0;0;2517;284592;15342
Hovedstaden;7-6-2021;F;131;0;4;2517;284723;15346
Midtjylland;7-6-2021;F;67;0;1;2517;284790;15347
Nordjylland;7-6-2021;F;38;0;0;2517;284828;15347
Sjælland;7-6-2021;F;30;0;1;2517;284858;15348
Syddanmark;7-6-2021;F;42;0;2;2517;284900;15350
Hovedstaden;7-6-2021;M;136;0;5;2517;285036;15355
Midtjylland;7-6-2021;M;56;0;1;2517;285092;15356
Nordjylland;7-6-2021;M;52;0;1;2517;285144;15357
Sjælland;7-6-2021;M;30;0;1;2517;285174;15358
Syddanmark;7-6-2021;M;33;0;0;2517;285207;15358
Hovedstaden;8-6-2021;F;98;0;3;2517;285305;15361
Midtjylland;8-6-2021;F;46;0;0;2517;285351;15361
Nordjylland;8-6-2021;F;32;0;0;2517;285383;15361
Sjælland;8-6-2021;F;33;0;1;2517;285416;15362
Syddanmark;8-6-2021;F;31;0;1;2517;285447;15363
Hovedstaden;8-6-2021;M;121;0;0;2517;285568;15363
Midtjylland;8-6-2021;M;51;0;3;2517;285619;15366
Nordjylland;8-6-2021;M;28;0;1;2517;285647;15367
Sjælland;8-6-2021;M;34;0;0;2517;285681;15367
Syddanmark;8-6-2021;M;31;0;2;2517;285712;15369
Hovedstaden;9-6-2021;F;100;0;3;2517;285812;15372
Midtjylland;9-6-2021;F;47;0;0;2517;285859;15372
Nordjylland;9-6-2021;F;24;0;0;2517;285883;15372
Sjælland;9-6-2021;F;42;0;1;2517;285925;15373
Syddanmark;9-6-2021;F;21;0;2;2517;285946;15375
Hovedstaden;9-6-2021;M;90;0;3;2517;286036;15378
Midtjylland;9-6-2021;M;54;0;2;2517;286090;15380
Nordjylland;9-6-2021;M;37;0;0;2517;286127;15380
Sjælland;9-6-2021;M;30;0;0;2517;286157;15380
Syddanmark;9-6-2021;M;28;0;0;2517;286185;15380
Hovedstaden;10-6-2021;F;85;0;3;2517;286270;15383
Midtjylland;10-6-2021;F;41;0;0;2517;286311;15383
Nordjylland;10-6-2021;F;39;0;0;2517;286350;15383
Sjælland;10-6-2021;F;25;0;1;2517;286375;15384
Syddanmark;10-6-2021;F;19;0;0;2517;286394;15384
Hovedstaden;10-6-2021;M;89;0;1;2517;286483;15385
Midtjylland;10-6-2021;M;39;1;2;2518;286522;15387
Nordjylland;10-6-2021;M;27;0;0;2518;286549;15387
Sjælland;10-6-2021;M;25;0;1;2518;286574;15388
Syddanmark;10-6-2021;M;27;0;0;2518;286601;15388
Hovedstaden;11-6-2021;F;56;0;0;2518;286657;15388
Midtjylland;11-6-2021;F;34;0;1;2518;286691;15389
Nordjylland;11-6-2021;F;23;0;2;2518;286714;15391
Sjælland;11-6-2021;F;12;0;0;2518;286726;15391
Syddanmark;11-6-2021;F;17;0;0;2518;286743;15391
Hovedstaden;11-6-2021;M;65;0;2;2518;286808;15393
Midtjylland;11-6-2021;M;41;0;2;2518;286849;15395
Nordjylland;11-6-2021;M;26;0;0;2518;286875;15395
Sjælland;11-6-2021;M;22;0;0;2518;286897;15395
Syddanmark;11-6-2021;M;14;0;0;2518;286911;15395
Hovedstaden;12-6-2021;F;50;1;7;2519;286961;15402
Midtjylland;12-6-2021;F;25;0;0;2519;286986;15402
Nordjylland;12-6-2021;F;20;0;0;2519;287006;15402
Sjælland;12-6-2021;F;14;0;1;2519;287020;15403
Syddanmark;12-6-2021;F;10;0;0;2519;287030;15403
Hovedstaden;12-6-2021;M;58;0;3;2519;287088;15406
Midtjylland;12-6-2021;M;18;0;0;2519;287106;15406
Nordjylland;12-6-2021;M;16;0;0;2519;287122;15406
Sjælland;12-6-2021;M;20;0;1;2519;287142;15407
Syddanmark;12-6-2021;M;13;0;1;2519;287155;15408
Hovedstaden;13-6-2021;F;45;1;5;2520;287200;15413
Midtjylland;13-6-2021;F;25;0;0;2520;287225;15413
Nordjylland;13-6-2021;F;17;0;2;2520;287242;15415
Sjælland;13-6-2021;F;9;0;0;2520;287251;15415
Syddanmark;13-6-2021;F;19;0;1;2520;287270;15416
Hovedstaden;13-6-2021;M;40;0;1;2520;287310;15417
Midtjylland;13-6-2021;M;25;0;0;2520;287335;15417
Nordjylland;13-6-2021;M;20;0;0;2520;287355;15417
Sjælland;13-6-2021;M;14;0;1;2520;287369;15418
Syddanmark;13-6-2021;M;12;0;0;2520;287381;15418
Hovedstaden;14-6-2021;F;63;0;2;2520;287444;15420
Midtjylland;14-6-2021;F;25;0;1;2520;287469;15421
Nordjylland;14-6-2021;F;30;0;0;2520;287499;15421
Sjælland;14-6-2021;F;18;0;0;2520;287517;15421
Syddanmark;14-6-2021;F;24;0;0;2520;287541;15421
Hovedstaden;14-6-2021;M;53;0;3;2520;287594;15424
Midtjylland;14-6-2021;M;35;0;1;2520;287629;15425
Nordjylland;14-6-2021;M;19;0;0;2520;287648;15425
Sjælland;14-6-2021;M;30;0;3;2520;287678;15428
Syddanmark;14-6-2021;M;9;0;0;2520;287687;15428
Hovedstaden;15-6-2021;F;57;0;2;2520;287744;15430
Midtjylland;15-6-2021;F;35;0;0;2520;287779;15430
Nordjylland;15-6-2021;F;23;0;0;2520;287802;15430
Sjælland;15-6-2021;F;11;0;0;2520;287813;15430
Syddanmark;15-6-2021;F;14;0;1;2520;287827;15431
Hovedstaden;15-6-2021;M;68;0;2;2520;287895;15433
Midtjylland;15-6-2021;M;26;0;0;2520;287921;15433
Nordjylland;15-6-2021;M;33;0;2;2520;287954;15435
Sjælland;15-6-2021;M;17;0;0;2520;287971;15435
Syddanmark;15-6-2021;M;19;0;0;2520;287990;15435
Hovedstaden;16-6-2021;F;64;0;2;2520;288054;15437
Midtjylland;16-6-2021;F;30;0;0;2520;288084;15437
Nordjylland;16-6-2021;F;11;0;0;2520;288095;15437
Sjælland;16-6-2021;F;23;0;0;2520;288118;15437
Syddanmark;16-6-2021;F;12;0;0;2520;288130;15437
Hovedstaden;16-6-2021;M;77;0;4;2520;288207;15441
Midtjylland;16-6-2021;M;31;0;1;2520;288238;15442
Nordjylland;16-6-2021;M;12;0;0;2520;288250;15442
Sjælland;16-6-2021;M;13;0;0;2520;288263;15442
Syddanmark;16-6-2021;M;13;0;0;2520;288276;15442
Hovedstaden;17-6-2021;F;49;0;0;2520;288325;15442
Midtjylland;17-6-2021;F;17;0;0;2520;288342;15442
Nordjylland;17-6-2021;F;19;0;1;2520;288361;15443
Sjælland;17-6-2021;F;16;0;3;2520;288377;15446
Syddanmark;17-6-2021;F;3;0;0;2520;288380;15446
Hovedstaden;17-6-2021;M;51;0;1;2520;288431;15447
Midtjylland;17-6-2021;M;20;0;0;2520;288451;15447
Nordjylland;17-6-2021;M;10;0;0;2520;288461;15447
Sjælland;17-6-2021;M;14;0;0;2520;288475;15447
Syddanmark;17-6-2021;M;12;0;1;2520;288487;15448
Hovedstaden;18-6-2021;F;46;0;0;2520;288533;15448
Midtjylland;18-6-2021;F;14;0;1;2520;288547;15449
Nordjylland;18-6-2021;F;13;0;0;2520;288560;15449
Sjælland;18-6-2021;F;9;0;0;2520;288569;15449
Syddanmark;18-6-2021;F;3;0;0;2520;288572;15449
Hovedstaden;18-6-2021;M;51;0;3;2520;288623;15452
Midtjylland;18-6-2021;M;29;0;0;2520;288652;15452
Nordjylland;18-6-2021;M;15;1;3;2521;288667;15455
Sjælland;18-6-2021;M;14;0;0;2521;288681;15455
Syddanmark;18-6-2021;M;6;0;0;2521;288687;15455
Hovedstaden;19-6-2021;F;38;0;1;2521;288725;15456
Midtjylland;19-6-2021;F;9;0;0;2521;288734;15456
Nordjylland;19-6-2021;F;10;1;2;2522;288744;15458
Sjælland;19-6-2021;F;12;0;0;2522;288756;15458
Syddanmark;19-6-2021;F;7;0;0;2522;288763;15458
Hovedstaden;19-6-2021;M;54;0;3;2522;288817;15461
Midtjylland;19-6-2021;M;12;0;0;2522;288829;15461
Nordjylland;19-6-2021;M;12;1;2;2523;288841;15463
Sjælland;19-6-2021;M;10;0;1;2523;288851;15464
Syddanmark;19-6-2021;M;7;0;0;2523;288858;15464
Hovedstaden;20-6-2021;F;39;0;0;2523;288897;15464
Midtjylland;20-6-2021;F;16;0;0;2523;288913;15464
Nordjylland;20-6-2021;F;9;0;0;2523;288922;15464
Sjælland;20-6-2021;F;6;0;2;2523;288928;15466
Syddanmark;20-6-2021;F;5;0;1;2523;288933;15467
Hovedstaden;20-6-2021;M;36;0;0;2523;288969;15467
Midtjylland;20-6-2021;M;23;0;2;2523;288992;15469
Nordjylland;20-6-2021;M;8;0;0;2523;289000;15469
Sjælland;20-6-2021;M;10;0;1;2523;289010;15470
Syddanmark;20-6-2021;M;5;0;0;2523;289015;15470
Hovedstaden;21-6-2021;F;45;0;2;2523;289060;15472
Midtjylland;21-6-2021;F;12;0;1;2523;289072;15473
Nordjylland;21-6-2021;F;5;0;1;2523;289077;15474
Sjælland;21-6-2021;F;4;0;0;2523;289081;15474
Syddanmark;21-6-2021;F;8;0;1;2523;289089;15475
Hovedstaden;21-6-2021;M;62;0;1;2523;289151;15476
Midtjylland;21-6-2021;M;17;0;0;2523;289168;15476
Nordjylland;21-6-2021;M;12;0;0;2523;289180;15476
Sjælland;21-6-2021;M;6;0;0;2523;289186;15476
Syddanmark;21-6-2021;M;17;0;0;2523;289203;15476
Hovedstaden;22-6-2021;F;47;0;1;2523;289250;15477
Midtjylland;22-6-2021;F;9;0;0;2523;289259;15477
Nordjylland;22-6-2021;F;10;0;0;2523;289269;15477
Sjælland;22-6-2021;F;4;0;1;2523;289273;15478
Syddanmark;22-6-2021;F;4;0;0;2523;289277;15478
Hovedstaden;22-6-2021;M;53;0;1;2523;289330;15479
Midtjylland;22-6-2021;M;12;0;0;2523;289342;15479
Nordjylland;22-6-2021;M;4;0;0;2523;289346;15479
Sjælland;22-6-2021;M;14;0;0;2523;289360;15479
Syddanmark;22-6-2021;M;17;0;0;2523;289377;15479
Hovedstaden;23-6-2021;F;48;0;1;2523;289425;15480
Midtjylland;23-6-2021;F;15;0;1;2523;289440;15481
Nordjylland;23-6-2021;F;21;0;1;2523;289461;15482
Sjælland;23-6-2021;F;6;0;0;2523;289467;15482
Syddanmark;23-6-2021;F;8;0;0;2523;289475;15482
Hovedstaden;23-6-2021;M;49;0;4;2523;289524;15486
Midtjylland;23-6-2021;M;21;0;0;2523;289545;15486
Nordjylland;23-6-2021;M;13;0;0;2523;289558;15486
Sjælland;23-6-2021;M;10;0;1;2523;289568;15487
Syddanmark;23-6-2021;M;11;0;0;2523;289579;15487
Hovedstaden;24-6-2021;F;51;0;1;2523;289630;15488
Midtjylland;24-6-2021;F;15;0;0;2523;289645;15488
Nordjylland;24-6-2021;F;8;0;0;2523;289653;15488
Sjælland;24-6-2021;F;8;0;1;2523;289661;15489
Syddanmark;24-6-2021;F;15;0;0;2523;289676;15489
Hovedstaden;24-6-2021;M;57;0;2;2523;289733;15491
Midtjylland;24-6-2021;M;27;0;0;2523;289760;15491
Nordjylland;24-6-2021;M;13;0;0;2523;289773;15491
Sjælland;24-6-2021;M;4;0;0;2523;289777;15491
Syddanmark;24-6-2021;M;13;0;1;2523;289790;15492
Hovedstaden;25-6-2021;F;40;0;1;2523;289830;15493
Midtjylland;25-6-2021;F;13;0;0;2523;289843;15493
Nordjylland;25-6-2021;F;6;0;0;2523;289849;15493
Sjælland;25-6-2021;F;10;0;1;2523;289859;15494
Syddanmark;25-6-2021;F;7;0;0;2523;289866;15494
Hovedstaden;25-6-2021;M;56;0;4;2523;289922;15498
Midtjylland;25-6-2021;M;23;0;1;2523;289945;15499
Nordjylland;25-6-2021;M;14;0;0;2523;289959;15499
Sjælland;25-6-2021;M;10;0;1;2523;289969;15500
Syddanmark;25-6-2021;M;11;0;0;2523;289980;15500
Hovedstaden;26-6-2021;F;44;0;4;2523;290024;15504
Midtjylland;26-6-2021;F;9;0;1;2523;290033;15505
Nordjylland;26-6-2021;F;5;0;0;2523;290038;15505
Sjælland;26-6-2021;F;2;0;0;2523;290040;15505
Syddanmark;26-6-2021;F;4;0;0;2523;290044;15505
Hovedstaden;26-6-2021;M;49;0;2;2523;290093;15507
Midtjylland;26-6-2021;M;7;0;0;2523;290100;15507
Nordjylland;26-6-2021;M;8;0;0;2523;290108;15507
Sjælland;26-6-2021;M;5;0;0;2523;290113;15507
Syddanmark;26-6-2021;M;11;0;0;2523;290124;15507
Hovedstaden;27-6-2021;F;64;0;0;2523;290188;15507
Midtjylland;27-6-2021;F;8;0;0;2523;290196;15507
Nordjylland;27-6-2021;F;8;0;0;2523;290204;15507
Sjælland;27-6-2021;F;3;0;0;2523;290207;15507
Syddanmark;27-6-2021;F;10;0;0;2523;290217;15507
Hovedstaden;27-6-2021;M;52;1;1;2524;290269;15508
Midtjylland;27-6-2021;M;10;0;0;2524;290279;15508
Nordjylland;27-6-2021;M;13;0;0;2524;290292;15508
Sjælland;27-6-2021;M;8;0;0;2524;290300;15508
Syddanmark;27-6-2021;M;8;0;0;2524;290308;15508
Hovedstaden;28-6-2021;F;84;0;1;2524;290392;15509
Midtjylland;28-6-2021;F;19;0;0;2524;290411;15509
Nordjylland;28-6-2021;F;17;0;0;2524;290428;15509
Sjælland;28-6-2021;F;6;0;1;2524;290434;15510
Syddanmark;28-6-2021;F;9;0;0;2524;290443;15510
Hovedstaden;28-6-2021;M;85;0;2;2524;290528;15512
Midtjylland;28-6-2021;M;21;0;0;2524;290549;15512
Nordjylland;28-6-2021;M;20;0;0;2524;290569;15512
Sjælland;28-6-2021;M;15;0;0;2524;290584;15512
Syddanmark;28-6-2021;M;9;0;0;2524;290593;15512
Hovedstaden;29-6-2021;F;118;0;0;2524;290711;15512
Midtjylland;29-6-2021;F;19;0;0;2524;290730;15512
Nordjylland;29-6-2021;F;22;0;0;2524;290752;15512
Sjælland;29-6-2021;F;24;0;0;2524;290776;15512
Syddanmark;29-6-2021;F;14;0;0;2524;290790;15512
Hovedstaden;29-6-2021;M;129;0;2;2524;290919;15514
Midtjylland;29-6-2021;M;18;0;1;2524;290937;15515
Nordjylland;29-6-2021;M;22;0;0;2524;290959;15515
Sjælland;29-6-2021;M;19;0;1;2524;290978;15516
Syddanmark;29-6-2021;M;6;0;0;2524;290984;15516
Hovedstaden;30-6-2021;F;126;0;2;2524;291110;15518
Midtjylland;30-6-2021;F;30;0;1;2524;291140;15519
Nordjylland;30-6-2021;F;11;0;0;2524;291151;15519
Sjælland;30-6-2021;F;19;0;0;2524;291170;15519
Syddanmark;30-6-2021;F;15;0;0;2524;291185;15519
Hovedstaden;30-6-2021;M;177;0;4;2524;291362;15523
Midtjylland;30-6-2021;M;28;0;2;2524;291390;15525
Nordjylland;30-6-2021;M;20;0;0;2524;291410;15525
Sjælland;30-6-2021;M;28;0;0;2524;291438;15525
Syddanmark;30-6-2021;M;17;0;1;2524;291455;15526
Hovedstaden;1-7-2021;F;86;0;0;2524;291541;15526
Midtjylland;1-7-2021;F;28;0;1;2524;291569;15527
Nordjylland;1-7-2021;F;11;0;2;2524;291580;15529
Sjælland;1-7-2021;F;30;0;4;2524;291610;15533
Syddanmark;1-7-2021;F;16;0;0;2524;291626;15533
Hovedstaden;1-7-2021;M;122;0;4;2524;291748;15537
Midtjylland;1-7-2021;M;17;0;0;2524;291765;15537
Nordjylland;1-7-2021;M;16;0;0;2524;291781;15537
Sjælland;1-7-2021;M;34;0;2;2524;291815;15539
Syddanmark;1-7-2021;M;25;0;0;2524;291840;15539
Hovedstaden;2-7-2021;F;89;0;2;2524;291929;15541
Midtjylland;2-7-2021;F;26;1;1;2525;291955;15542
Nordjylland;2-7-2021;F;10;0;0;2525;291965;15542
Sjælland;2-7-2021;F;12;0;0;2525;291977;15542
Syddanmark;2-7-2021;F;14;0;0;2525;291991;15542
Hovedstaden;2-7-2021;M;132;0;2;2525;292123;15544
Midtjylland;2-7-2021;M;27;0;0;2525;292150;15544
Nordjylland;2-7-2021;M;16;0;0;2525;292166;15544
Sjælland;2-7-2021;M;26;0;1;2525;292192;15545
Syddanmark;2-7-2021;M;17;0;0;2525;292209;15545
Hovedstaden;3-7-2021;F;81;0;1;2525;292290;15546
Midtjylland;3-7-2021;F;24;0;0;2525;292314;15546
Nordjylland;3-7-2021;F;9;0;0;2525;292323;15546
Sjælland;3-7-2021;F;20;0;2;2525;292343;15548
Syddanmark;3-7-2021;F;11;0;0;2525;292354;15548
Hovedstaden;3-7-2021;M;103;1;2;2526;292457;15550
Midtjylland;3-7-2021;M;29;0;1;2526;292486;15551
Nordjylland;3-7-2021;M;28;0;0;2526;292514;15551
Sjælland;3-7-2021;M;26;0;0;2526;292540;15551
Syddanmark;3-7-2021;M;21;0;0;2526;292561;15551
Hovedstaden;4-7-2021;F;101;0;2;2526;292662;15553
Midtjylland;4-7-2021;F;29;0;2;2526;292691;15555
Nordjylland;4-7-2021;F;13;0;0;2526;292704;15555
Sjælland;4-7-2021;F;15;0;0;2526;292719;15555
Syddanmark;4-7-2021;F;23;0;0;2526;292742;15555
Hovedstaden;4-7-2021;M;125;0;2;2526;292867;15557
Midtjylland;4-7-2021;M;35;1;2;2527;292902;15559
Nordjylland;4-7-2021;M;15;0;0;2527;292917;15559
Sjælland;4-7-2021;M;24;0;1;2527;292941;15560
Syddanmark;4-7-2021;M;22;0;0;2527;292963;15560
Hovedstaden;5-7-2021;F;157;1;4;2528;293120;15564
Midtjylland;5-7-2021;F;66;0;0;2528;293186;15564
Nordjylland;5-7-2021;F;18;0;0;2528;293204;15564
Sjælland;5-7-2021;F;27;0;0;2528;293231;15564
Syddanmark;5-7-2021;F;51;0;1;2528;293282;15565
Hovedstaden;5-7-2021;M;151;0;4;2528;293433;15569
Midtjylland;5-7-2021;M;80;0;0;2528;293513;15569
Nordjylland;5-7-2021;M;28;0;0;2528;293541;15569
Sjælland;5-7-2021;M;30;0;0;2528;293571;15569
Syddanmark;5-7-2021;M;59;0;1;2528;293630;15570
Hovedstaden;6-7-2021;F;168;0;7;2528;293798;15577
Midtjylland;6-7-2021;F;58;0;1;2528;293856;15578
Nordjylland;6-7-2021;F;16;0;0;2528;293872;15578
Sjælland;6-7-2021;F;30;0;1;2528;293902;15579
Syddanmark;6-7-2021;F;47;0;0;2528;293949;15579
Hovedstaden;6-7-2021;M;179;0;4;2528;294128;15583
Midtjylland;6-7-2021;M;53;0;1;2528;294181;15584
Nordjylland;6-7-2021;M;18;0;0;2528;294199;15584
Sjælland;6-7-2021;M;19;0;1;2528;294218;15585
Syddanmark;6-7-2021;M;60;0;1;2528;294278;15586
Hovedstaden;7-7-2021;F;129;0;3;2528;294407;15589
Midtjylland;7-7-2021;F;66;0;1;2528;294473;15590
Nordjylland;7-7-2021;F;22;0;1;2528;294495;15591
Sjælland;7-7-2021;F;25;0;1;2528;294520;15592
Syddanmark;7-7-2021;F;37;0;0;2528;294557;15592
Hovedstaden;7-7-2021;M;164;0;2;2528;294721;15594
Midtjylland;7-7-2021;M;77;0;1;2528;294798;15595
Nordjylland;7-7-2021;M;14;0;0;2528;294812;15595
Sjælland;7-7-2021;M;30;0;2;2528;294842;15597
Syddanmark;7-7-2021;M;45;0;0;2528;294887;15597
Hovedstaden;8-7-2021;F;129;0;3;2528;295016;15600
Midtjylland;8-7-2021;F;59;0;2;2528;295075;15602
Nordjylland;8-7-2021;F;16;0;0;2528;295091;15602
Sjælland;8-7-2021;F;24;0;0;2528;295115;15602
Syddanmark;8-7-2021;F;26;0;3;2528;295141;15605
Hovedstaden;8-7-2021;M;136;0;3;2528;295277;15608
Midtjylland;8-7-2021;M;61;0;0;2528;295338;15608
Nordjylland;8-7-2021;M;19;0;1;2528;295357;15609
Sjælland;8-7-2021;M;29;0;0;2528;295386;15609
Syddanmark;8-7-2021;M;34;0;0;2528;295420;15609
Hovedstaden;9-7-2021;F;134;0;3;2528;295554;15612
Midtjylland;9-7-2021;F;65;0;2;2528;295619;15614
Nordjylland;9-7-2021;F;9;0;1;2528;295628;15615
Sjælland;9-7-2021;F;14;0;1;2528;295642;15616
Syddanmark;9-7-2021;F;25;0;1;2528;295667;15617
Hovedstaden;9-7-2021;M;163;0;1;2528;295830;15618
Midtjylland;9-7-2021;M;63;0;0;2528;295893;15618
Nordjylland;9-7-2021;M;18;0;0;2528;295911;15618
Sjælland;9-7-2021;M;35;0;0;2528;295946;15618
Syddanmark;9-7-2021;M;34;0;0;2528;295980;15618
Hovedstaden;10-7-2021;F;165;0;1;2528;296145;15619
Midtjylland;10-7-2021;F;64;0;0;2528;296209;15619
Nordjylland;10-7-2021;F;13;0;0;2528;296222;15619
Sjælland;10-7-2021;F;25;0;0;2528;296247;15619
Syddanmark;10-7-2021;F;43;0;0;2528;296290;15619
Hovedstaden;10-7-2021;M;184;0;3;2528;296474;15622
Midtjylland;10-7-2021;M;65;0;0;2528;296539;15622
Nordjylland;10-7-2021;M;20;0;0;2528;296559;15622
Sjælland;10-7-2021;M;35;0;0;2528;296594;15622
Syddanmark;10-7-2021;M;34;0;0;2528;296628;15622
Hovedstaden;11-7-2021;F;192;0;5;2528;296820;15627
Midtjylland;11-7-2021;F;84;0;3;2528;296904;15630
Nordjylland;11-7-2021;F;12;0;1;2528;296916;15631
Sjælland;11-7-2021;F;31;0;0;2528;296947;15631
Syddanmark;11-7-2021;F;55;0;2;2528;297002;15633
Hovedstaden;11-7-2021;M;284;0;4;2528;297286;15637
Midtjylland;11-7-2021;M;125;0;3;2528;297411;15640
Nordjylland;11-7-2021;M;29;0;0;2528;297440;15640
Sjælland;11-7-2021;M;32;0;0;2528;297472;15640
Syddanmark;11-7-2021;M;70;0;2;2528;297542;15642
Hovedstaden;12-7-2021;F;267;0;3;2528;297809;15645
Midtjylland;12-7-2021;F;109;0;3;2528;297918;15648
Nordjylland;12-7-2021;F;22;0;0;2528;297940;15648
Sjælland;12-7-2021;F;38;0;1;2528;297978;15649
Syddanmark;12-7-2021;F;54;1;1;2529;298032;15650
Hovedstaden;12-7-2021;M;301;0;4;2529;298333;15654
Midtjylland;12-7-2021;M;153;0;3;2529;298486;15657
Nordjylland;12-7-2021;M;23;0;1;2529;298509;15658
Sjælland;12-7-2021;M;45;0;2;2529;298554;15660
Syddanmark;12-7-2021;M;86;1;4;2530;298640;15664
Hovedstaden;13-7-2021;F;286;0;0;2530;298926;15664
Midtjylland;13-7-2021;F;118;1;3;2531;299044;15667
Nordjylland;13-7-2021;F;22;0;0;2531;299066;15667
Sjælland;13-7-2021;F;40;0;1;2531;299106;15668
Syddanmark;13-7-2021;F;59;0;2;2531;299165;15670
Hovedstaden;13-7-2021;M;336;0;6;2531;299501;15676
Midtjylland;13-7-2021;M;147;0;0;2531;299648;15676
Nordjylland;13-7-2021;M;30;0;0;2531;299678;15676
Sjælland;13-7-2021;M;56;0;1;2531;299734;15677
Syddanmark;13-7-2021;M;97;0;2;2531;299831;15679
Hovedstaden;14-7-2021;F;279;0;3;2531;300110;15682
Midtjylland;14-7-2021;F;140;0;1;2531;300250;15683
Nordjylland;14-7-2021;F;21;0;0;2531;300271;15683
Sjælland;14-7-2021;F;49;0;3;2531;300320;15686
Syddanmark;14-7-2021;F;49;0;1;2531;300369;15687
Hovedstaden;14-7-2021;M;328;0;4;2531;300697;15691
Midtjylland;14-7-2021;M;158;0;2;2531;300855;15693
Nordjylland;14-7-2021;M;25;0;1;2531;300880;15694
Sjælland;14-7-2021;M;53;0;1;2531;300933;15695
Syddanmark;14-7-2021;M;81;0;1;2531;301014;15696
Hovedstaden;15-7-2021;F;258;0;3;2531;301272;15699
Midtjylland;15-7-2021;F;101;0;3;2531;301373;15702
Nordjylland;15-7-2021;F;27;0;0;2531;301400;15702
Sjælland;15-7-2021;F;34;0;0;2531;301434;15702
Syddanmark;15-7-2021;F;55;0;1;2531;301489;15703
Hovedstaden;15-7-2021;M;291;0;6;2531;301780;15709
Midtjylland;15-7-2021;M;138;0;3;2531;301918;15712
Nordjylland;15-7-2021;M;18;0;0;2531;301936;15712
Sjælland;15-7-2021;M;40;0;4;2531;301976;15716
Syddanmark;15-7-2021;M;65;1;0;2532;302041;15716
Hovedstaden;16-7-2021;F;173;0;3;2532;302214;15719
Midtjylland;16-7-2021;F;95;0;1;2532;302309;15720
Nordjylland;16-7-2021;F;12;0;0;2532;302321;15720
Sjælland;16-7-2021;F;37;0;1;2532;302358;15721
Syddanmark;16-7-2021;F;46;0;2;2532;302404;15723
Hovedstaden;16-7-2021;M;228;1;3;2533;302632;15726
Midtjylland;16-7-2021;M;101;0;1;2533;302733;15727
Nordjylland;16-7-2021;M;21;0;0;2533;302754;15727
Sjælland;16-7-2021;M;43;0;0;2533;302797;15727
Syddanmark;16-7-2021;M;44;0;0;2533;302841;15727
Hovedstaden;17-7-2021;F;182;0;2;2533;303023;15729
Midtjylland;17-7-2021;F;89;1;3;2534;303112;15732
Nordjylland;17-7-2021;F;15;0;0;2534;303127;15732
Sjælland;17-7-2021;F;30;0;2;2534;303157;15734
Syddanmark;17-7-2021;F;47;0;0;2534;303204;15734
Hovedstaden;17-7-2021;M;202;0;4;2534;303406;15738
Midtjylland;17-7-2021;M;82;0;0;2534;303488;15738
Nordjylland;17-7-2021;M;28;0;0;2534;303516;15738
Sjælland;17-7-2021;M;43;0;1;2534;303559;15739
Syddanmark;17-7-2021;M;54;0;0;2534;303613;15739
Hovedstaden;18-7-2021;F;155;0;2;2534;303768;15741
Midtjylland;18-7-2021;F;78;0;0;2534;303846;15741
Nordjylland;18-7-2021;F;15;0;0;2534;303861;15741
Sjælland;18-7-2021;F;32;0;0;2534;303893;15741
Syddanmark;18-7-2021;F;51;0;1;2534;303944;15742
Hovedstaden;18-7-2021;M;165;0;2;2534;304109;15744
Midtjylland;18-7-2021;M;81;0;0;2534;304190;15744
Nordjylland;18-7-2021;M;24;0;0;2534;304214;15744
Sjælland;18-7-2021;M;57;1;1;2535;304271;15745
Syddanmark;18-7-2021;M;49;0;1;2535;304320;15746
Hovedstaden;19-7-2021;F;183;0;1;2535;304503;15747
Midtjylland;19-7-2021;F;113;0;3;2535;304616;15750
Nordjylland;19-7-2021;F;29;0;0;2535;304645;15750
Sjælland;19-7-2021;F;39;0;3;2535;304684;15753
Syddanmark;19-7-2021;F;48;0;2;2535;304732;15755
Hovedstaden;19-7-2021;M;203;1;3;2536;304935;15758
Midtjylland;19-7-2021;M;123;0;1;2536;305058;15759
Nordjylland;19-7-2021;M;31;0;0;2536;305089;15759
Sjælland;19-7-2021;M;34;0;1;2536;305123;15760
Syddanmark;19-7-2021;M;46;0;1;2536;305169;15761
Hovedstaden;20-7-2021;F;181;0;5;2536;305350;15766
Midtjylland;20-7-2021;F;76;0;1;2536;305426;15767
Nordjylland;20-7-2021;F;18;0;0;2536;305444;15767
Sjælland;20-7-2021;F;24;0;0;2536;305468;15767
Syddanmark;20-7-2021;F;55;0;2;2536;305523;15769
Hovedstaden;20-7-2021;M;208;0;3;2536;305731;15772
Midtjylland;20-7-2021;M;117;0;2;2536;305848;15774
Nordjylland;20-7-2021;M;17;0;0;2536;305865;15774
Sjælland;20-7-2021;M;36;0;0;2536;305901;15774
Syddanmark;20-7-2021;M;66;0;0;2536;305967;15774
Hovedstaden;21-7-2021;F;198;0;4;2536;306165;15778
Midtjylland;21-7-2021;F;81;0;0;2536;306246;15778
Nordjylland;21-7-2021;F;28;0;0;2536;306274;15778
Sjælland;21-7-2021;F;32;0;0;2536;306306;15778
Syddanmark;21-7-2021;F;42;0;0;2536;306348;15778
Hovedstaden;21-7-2021;M;170;1;2;2537;306518;15780
Midtjylland;21-7-2021;M;118;0;3;2537;306636;15783
Nordjylland;21-7-2021;M;32;0;1;2537;306668;15784
Sjælland;21-7-2021;M;34;0;2;2537;306702;15786
Syddanmark;21-7-2021;M;58;0;0;2537;306760;15786
Hovedstaden;22-7-2021;F;128;0;2;2537;306888;15788
Midtjylland;22-7-2021;F;90;0;2;2537;306978;15790
Nordjylland;22-7-2021;F;28;0;0;2537;307006;15790
Sjælland;22-7-2021;F;35;0;0;2537;307041;15790
Syddanmark;22-7-2021;F;46;0;1;2537;307087;15791
Hovedstaden;22-7-2021;M;168;0;3;2537;307255;15794
Midtjylland;22-7-2021;M;91;0;3;2537;307346;15797
Nordjylland;22-7-2021;M;21;0;1;2537;307367;15798
Sjælland;22-7-2021;M;34;0;1;2537;307401;15799
Syddanmark;22-7-2021;M;53;0;2;2537;307454;15801
Hovedstaden;23-7-2021;F;139;1;4;2538;307593;15805
Midtjylland;23-7-2021;F;93;0;3;2538;307686;15808
Nordjylland;23-7-2021;F;19;0;0;2538;307705;15808
Sjælland;23-7-2021;F;29;0;1;2538;307734;15809
Syddanmark;23-7-2021;F;52;0;0;2538;307786;15809
Hovedstaden;23-7-2021;M;157;2;5;2540;307943;15814
Midtjylland;23-7-2021;M;100;0;0;2540;308043;15814
Nordjylland;23-7-2021;M;27;0;1;2540;308070;15815
Sjælland;23-7-2021;M;32;1;2;2541;308102;15817
Syddanmark;23-7-2021;M;72;0;0;2541;308174;15817
Hovedstaden;24-7-2021;F;133;0;4;2541;308307;15821
Midtjylland;24-7-2021;F;81;0;1;2541;308388;15822
Nordjylland;24-7-2021;F;27;0;0;2541;308415;15822
Sjælland;24-7-2021;F;27;0;4;2541;308442;15826
Syddanmark;24-7-2021;F;28;0;1;2541;308470;15827
Hovedstaden;24-7-2021;M;130;0;3;2541;308600;15830
Midtjylland;24-7-2021;M;101;0;0;2541;308701;15830
Nordjylland;24-7-2021;M;31;0;0;2541;308732;15830
Sjælland;24-7-2021;M;22;0;0;2541;308754;15830
Syddanmark;24-7-2021;M;48;0;0;2541;308802;15830
Hovedstaden;25-7-2021;F;142;0;4;2541;308944;15834
Midtjylland;25-7-2021;F;93;0;0;2541;309037;15834
Nordjylland;25-7-2021;F;23;0;0;2541;309060;15834
Sjælland;25-7-2021;F;25;0;0;2541;309085;15834
Syddanmark;25-7-2021;F;59;0;2;2541;309144;15836
Hovedstaden;25-7-2021;M;200;0;4;2541;309344;15840
Midtjylland;25-7-2021;M;106;1;2;2542;309450;15842
Nordjylland;25-7-2021;M;32;0;0;2542;309482;15842
Sjælland;25-7-2021;M;27;0;2;2542;309509;15844
Syddanmark;25-7-2021;M;56;0;0;2542;309565;15844
Hovedstaden;26-7-2021;F;190;0;4;2542;309755;15848
Midtjylland;26-7-2021;F;125;0;0;2542;309880;15848
Nordjylland;26-7-2021;F;46;0;0;2542;309926;15848
Sjælland;26-7-2021;F;50;0;0;2542;309976;15848
Syddanmark;26-7-2021;F;69;0;5;2542;310045;15853
Hovedstaden;26-7-2021;M;209;0;1;2542;310254;15854
Midtjylland;26-7-2021;M;149;0;2;2542;310403;15856
Nordjylland;26-7-2021;M;62;0;0;2542;310465;15856
Sjælland;26-7-2021;M;39;0;2;2542;310504;15858
Syddanmark;26-7-2021;M;78;0;0;2542;310582;15858
Hovedstaden;27-7-2021;F;202;0;5;2542;310784;15863
Midtjylland;27-7-2021;F;118;1;0;2543;310902;15863
Nordjylland;27-7-2021;F;59;0;0;2543;310961;15863
Sjælland;27-7-2021;F;31;0;0;2543;310992;15863
Syddanmark;27-7-2021;F;53;0;0;2543;311045;15863
Hovedstaden;27-7-2021;M;190;0;2;2543;311235;15865
Midtjylland;27-7-2021;M;131;1;1;2544;311366;15866
Nordjylland;27-7-2021;M;66;0;0;2544;311432;15866
Sjælland;27-7-2021;M;40;0;2;2544;311472;15868
Syddanmark;27-7-2021;M;62;0;2;2544;311534;15870
Hovedstaden;28-7-2021;F;184;0;7;2544;311718;15877
Midtjylland;28-7-2021;F;106;0;3;2544;311824;15880
Nordjylland;28-7-2021;F;81;0;0;2544;311905;15880
Sjælland;28-7-2021;F;32;0;0;2544;311937;15880
Syddanmark;28-7-2021;F;62;0;0;2544;311999;15880
Hovedstaden;28-7-2021;M;189;0;7;2544;312188;15887
Midtjylland;28-7-2021;M;108;0;0;2544;312296;15887
Nordjylland;28-7-2021;M;79;0;0;2544;312375;15887
Sjælland;28-7-2021;M;35;0;2;2544;312410;15889
Syddanmark;28-7-2021;M;93;1;3;2545;312503;15892
Hovedstaden;29-7-2021;F;157;0;3;2545;312660;15895
Midtjylland;29-7-2021;F;101;0;2;2545;312761;15897
Nordjylland;29-7-2021;F;54;0;1;2545;312815;15898
Sjælland;29-7-2021;F;25;0;0;2545;312840;15898
Syddanmark;29-7-2021;F;75;0;4;2545;312915;15902
Hovedstaden;29-7-2021;M;151;0;4;2545;313066;15906
Midtjylland;29-7-2021;M;120;0;2;2545;313186;15908
Nordjylland;29-7-2021;M;72;0;0;2545;313258;15908
Sjælland;29-7-2021;M;36;0;1;2545;313294;15909
Syddanmark;29-7-2021;M;84;0;2;2545;313378;15911
Hovedstaden;30-7-2021;F;157;0;3;2545;313535;15914
Midtjylland;30-7-2021;F;91;0;2;2545;313626;15916
Nordjylland;30-7-2021;F;41;0;0;2545;313667;15916
Sjælland;30-7-2021;F;38;0;0;2545;313705;15916
Syddanmark;30-7-2021;F;57;1;0;2546;313762;15916
Hovedstaden;30-7-2021;M;173;1;9;2547;313935;15925
Midtjylland;30-7-2021;M;118;0;0;2547;314053;15925
Nordjylland;30-7-2021;M;48;0;1;2547;314101;15926
Sjælland;30-7-2021;M;39;0;2;2547;314140;15928
Syddanmark;30-7-2021;M;65;0;1;2547;314205;15929
Hovedstaden;31-7-2021;F;151;0;2;2547;314356;15931
Midtjylland;31-7-2021;F;88;0;2;2547;314444;15933
Nordjylland;31-7-2021;F;44;0;0;2547;314488;15933
Sjælland;31-7-2021;F;30;0;1;2547;314518;15934
Syddanmark;31-7-2021;F;57;0;2;2547;314575;15936
Hovedstaden;31-7-2021;M;131;0;1;2547;314706;15937
Midtjylland;31-7-2021;M;90;0;2;2547;314796;15939
Nordjylland;31-7-2021;M;71;0;0;2547;314867;15939
Sjælland;31-7-2021;M;25;0;1;2547;314892;15940
Syddanmark;31-7-2021;M;52;0;1;2547;314944;15941
Hovedstaden;1-8-2021;F;150;0;3;2547;315094;15944
Midtjylland;1-8-2021;F;86;0;2;2547;315180;15946
Nordjylland;1-8-2021;F;67;0;0;2547;315247;15946
Sjælland;1-8-2021;F;50;1;4;2548;315297;15950
Syddanmark;1-8-2021;F;57;0;2;2548;315354;15952
Hovedstaden;1-8-2021;M;176;0;2;2548;315530;15954
Midtjylland;1-8-2021;M;93;0;3;2548;315623;15957
Nordjylland;1-8-2021;M;48;0;0;2548;315671;15957
Sjælland;1-8-2021;M;25;0;0;2548;315696;15957
Syddanmark;1-8-2021;M;69;0;4;2548;315765;15961
Hovedstaden;2-8-2021;F;163;0;4;2548;315928;15965
Midtjylland;2-8-2021;F;107;0;3;2548;316035;15968
Nordjylland;2-8-2021;F;54;0;0;2548;316089;15968
Sjælland;2-8-2021;F;36;0;0;2548;316125;15968
Syddanmark;2-8-2021;F;69;0;3;2548;316194;15971
Hovedstaden;2-8-2021;M;171;0;7;2548;316365;15978
Midtjylland;2-8-2021;M;120;0;0;2548;316485;15978
Nordjylland;2-8-2021;M;59;0;0;2548;316544;15978
Sjælland;2-8-2021;M;42;1;2;2549;316586;15980
Syddanmark;2-8-2021;M;75;0;2;2549;316661;15982
Hovedstaden;3-8-2021;F;149;0;6;2549;316810;15988
Midtjylland;3-8-2021;F;112;0;4;2549;316922;15992
Nordjylland;3-8-2021;F;36;0;0;2549;316958;15992
Sjælland;3-8-2021;F;47;0;0;2549;317005;15992
Syddanmark;3-8-2021;F;67;0;1;2549;317072;15993
Hovedstaden;3-8-2021;M;152;0;3;2549;317224;15996
Midtjylland;3-8-2021;M;127;0;2;2549;317351;15998
Nordjylland;3-8-2021;M;50;0;0;2549;317401;15998
Sjælland;3-8-2021;M;45;0;0;2549;317446;15998
Syddanmark;3-8-2021;M;82;0;4;2549;317528;16002
Hovedstaden;4-8-2021;F;180;0;6;2549;317708;16008
Midtjylland;4-8-2021;F;94;0;3;2549;317802;16011
Nordjylland;4-8-2021;F;51;0;3;2549;317853;16014
Sjælland;4-8-2021;F;30;1;1;2550;317883;16015
Syddanmark;4-8-2021;F;82;0;0;2550;317965;16015
Hovedstaden;4-8-2021;M;166;0;4;2550;318131;16019
Midtjylland;4-8-2021;M;119;0;3;2550;318250;16022
Nordjylland;4-8-2021;M;61;0;0;2550;318311;16022
Sjælland;4-8-2021;M;37;0;0;2550;318348;16022
Syddanmark;4-8-2021;M;89;0;3;2550;318437;16025
Hovedstaden;5-8-2021;F;171;0;5;2550;318608;16030
Midtjylland;5-8-2021;F;98;0;1;2550;318706;16031
Nordjylland;5-8-2021;F;59;0;1;2550;318765;16032
Sjælland;5-8-2021;F;33;1;1;2551;318798;16033
Syddanmark;5-8-2021;F;80;0;2;2551;318878;16035
Hovedstaden;5-8-2021;M;180;1;3;2552;319058;16038
Midtjylland;5-8-2021;M;102;0;0;2552;319160;16038
Nordjylland;5-8-2021;M;61;0;2;2552;319221;16040
Sjælland;5-8-2021;M;40;0;1;2552;319261;16041
Syddanmark;5-8-2021;M;97;0;3;2552;319358;16044
Hovedstaden;6-8-2021;F;181;0;3;2552;319539;16047
Midtjylland;6-8-2021;F;92;0;1;2552;319631;16048
Nordjylland;6-8-2021;F;46;0;0;2552;319677;16048
Sjælland;6-8-2021;F;47;0;2;2552;319724;16050
Syddanmark;6-8-2021;F;68;0;2;2552;319792;16052
Hovedstaden;6-8-2021;M;186;0;3;2552;319978;16055
Midtjylland;6-8-2021;M;110;0;1;2552;320088;16056
Nordjylland;6-8-2021;M;63;0;2;2552;320151;16058
Sjælland;6-8-2021;M;40;0;1;2552;320191;16059
Syddanmark;6-8-2021;M;71;0;1;2552;320262;16060
Hovedstaden;7-8-2021;F;197;0;6;2552;320459;16066
Midtjylland;7-8-2021;F;96;0;1;2552;320555;16067
Nordjylland;7-8-2021;F;51;0;0;2552;320606;16067
Sjælland;7-8-2021;F;36;0;2;2552;320642;16069
Syddanmark;7-8-2021;F;55;0;2;2552;320697;16071
Hovedstaden;7-8-2021;M;174;0;8;2552;320871;16079
Midtjylland;7-8-2021;M;91;0;3;2552;320962;16082
Nordjylland;7-8-2021;M;38;0;0;2552;321000;16082
Sjælland;7-8-2021;M;24;0;0;2552;321024;16082
Syddanmark;7-8-2021;M;69;0;0;2552;321093;16082
Hovedstaden;8-8-2021;F;193;0;4;2552;321286;16086
Midtjylland;8-8-2021;F;105;0;2;2552;321391;16088
Nordjylland;8-8-2021;F;55;0;0;2552;321446;16088
Sjælland;8-8-2021;F;40;0;3;2552;321486;16091
Syddanmark;8-8-2021;F;76;0;2;2552;321562;16093
Hovedstaden;8-8-2021;M;193;1;6;2553;321755;16099
Midtjylland;8-8-2021;M;122;0;2;2553;321877;16101
Nordjylland;8-8-2021;M;60;0;1;2553;321937;16102
Sjælland;8-8-2021;M;46;0;0;2553;321983;16102
Syddanmark;8-8-2021;M;78;0;5;2553;322061;16107
Hovedstaden;9-8-2021;F;252;0;7;2553;322313;16114
Midtjylland;9-8-2021;F;97;0;4;2553;322410;16118
Nordjylland;9-8-2021;F;73;0;2;2553;322483;16120
Sjælland;9-8-2021;F;53;0;0;2553;322536;16120
Syddanmark;9-8-2021;F;89;0;2;2553;322625;16122
Hovedstaden;9-8-2021;M;214;0;8;2553;322839;16130
Midtjylland;9-8-2021;M;100;1;4;2554;322939;16134
Nordjylland;9-8-2021;M;45;0;3;2554;322984;16137
Sjælland;9-8-2021;M;68;0;1;2554;323052;16138
Syddanmark;9-8-2021;M;84;0;1;2554;323136;16139
Hovedstaden;10-8-2021;F;197;0;4;2554;323333;16143
Midtjylland;10-8-2021;F;123;0;3;2554;323456;16146
Nordjylland;10-8-2021;F;50;0;0;2554;323506;16146
Sjælland;10-8-2021;F;60;1;3;2555;323566;16149
Syddanmark;10-8-2021;F;80;0;3;2555;323646;16152
Hovedstaden;10-8-2021;M;211;2;11;2557;323857;16163
Midtjylland;10-8-2021;M;130;0;1;2557;323987;16164
Nordjylland;10-8-2021;M;62;0;1;2557;324049;16165
Sjælland;10-8-2021;M;49;0;0;2557;324098;16165
Syddanmark;10-8-2021;M;97;0;3;2557;324195;16168
Hovedstaden;11-8-2021;F;205;0;6;2557;324400;16174
Midtjylland;11-8-2021;F;116;0;2;2557;324516;16176
Nordjylland;11-8-2021;F;44;0;0;2557;324560;16176
Sjælland;11-8-2021;F;65;0;5;2557;324625;16181
Syddanmark;11-8-2021;F;68;0;4;2557;324693;16185
Hovedstaden;11-8-2021;M;181;0;5;2557;324874;16190
Midtjylland;11-8-2021;M;116;0;1;2557;324990;16191
Nordjylland;11-8-2021;M;58;1;4;2558;325048;16195
Sjælland;11-8-2021;M;58;0;2;2558;325106;16197
Syddanmark;11-8-2021;M;64;0;2;2558;325170;16199
Hovedstaden;12-8-2021;F;195;1;8;2559;325365;16207
Midtjylland;12-8-2021;F;134;0;5;2559;325499;16212
Nordjylland;12-8-2021;F;57;0;1;2559;325556;16213
Sjælland;12-8-2021;F;52;0;1;2559;325608;16214
Syddanmark;12-8-2021;F;79;0;2;2559;325687;16216
Hovedstaden;12-8-2021;M;179;0;7;2559;325866;16223
Midtjylland;12-8-2021;M;118;0;1;2559;325984;16224
Nordjylland;12-8-2021;M;53;0;0;2559;326037;16224
Sjælland;12-8-2021;M;60;0;1;2559;326097;16225
Syddanmark;12-8-2021;M;63;0;2;2559;326160;16227
Hovedstaden;13-8-2021;F;199;0;4;2559;326359;16231
Midtjylland;13-8-2021;F;110;0;4;2559;326469;16235
Nordjylland;13-8-2021;F;51;0;0;2559;326520;16235
Sjælland;13-8-2021;F;62;0;4;2559;326582;16239
Syddanmark;13-8-2021;F;73;0;0;2559;326655;16239
Hovedstaden;13-8-2021;M;193;1;9;2560;326848;16248
Midtjylland;13-8-2021;M;94;0;5;2560;326942;16253
Nordjylland;13-8-2021;M;53;0;1;2560;326995;16254
Sjælland;13-8-2021;M;60;0;1;2560;327055;16255
Syddanmark;13-8-2021;M;57;0;0;2560;327112;16255
Hovedstaden;14-8-2021;F;149;1;8;2561;327261;16263
Midtjylland;14-8-2021;F;98;0;1;2561;327359;16264
Nordjylland;14-8-2021;F;39;0;1;2561;327398;16265
Sjælland;14-8-2021;F;42;0;1;2561;327440;16266
Syddanmark;14-8-2021;F;82;0;4;2561;327522;16270
Hovedstaden;14-8-2021;M;171;1;5;2562;327693;16275
Midtjylland;14-8-2021;M;99;0;5;2562;327792;16280
Nordjylland;14-8-2021;M;38;0;0;2562;327830;16280
Sjælland;14-8-2021;M;31;0;3;2562;327861;16283
Syddanmark;14-8-2021;M;65;0;4;2562;327926;16287
Hovedstaden;15-8-2021;F;187;0;6;2562;328113;16293
Midtjylland;15-8-2021;F;130;0;6;2562;328243;16299
Nordjylland;15-8-2021;F;34;0;1;2562;328277;16300
Sjælland;15-8-2021;F;43;0;2;2562;328320;16302
Syddanmark;15-8-2021;F;89;0;2;2562;328409;16304
Hovedstaden;15-8-2021;M;201;0;6;2562;328610;16310
Midtjylland;15-8-2021;M;113;0;3;2562;328723;16313
Nordjylland;15-8-2021;M;33;0;1;2562;328756;16314
Sjælland;15-8-2021;M;30;0;0;2562;328786;16314
Syddanmark;15-8-2021;M;73;0;4;2562;328859;16318
Hovedstaden;16-8-2021;F;225;1;7;2563;329084;16325
Midtjylland;16-8-2021;F;132;1;4;2564;329216;16329
Nordjylland;16-8-2021;F;49;0;1;2564;329265;16330
Sjælland;16-8-2021;F;46;0;2;2564;329311;16332
Syddanmark;16-8-2021;F;128;0;2;2564;329439;16334
Hovedstaden;16-8-2021;M;190;0;7;2564;329629;16341
Midtjylland;16-8-2021;M;118;0;1;2564;329747;16342
Nordjylland;16-8-2021;M;51;0;2;2564;329798;16344
Sjælland;16-8-2021;M;52;0;2;2564;329850;16346
Syddanmark;16-8-2021;M;94;0;2;2564;329944;16348
Hovedstaden;17-8-2021;F;178;0;9;2564;330122;16357
Midtjylland;17-8-2021;F;116;0;4;2564;330238;16361
Nordjylland;17-8-2021;F;54;1;3;2565;330292;16364
Sjælland;17-8-2021;F;47;0;0;2565;330339;16364
Syddanmark;17-8-2021;F;105;0;2;2565;330444;16366
Hovedstaden;17-8-2021;M;187;0;6;2565;330631;16372
Midtjylland;17-8-2021;M;128;0;2;2565;330759;16374
Nordjylland;17-8-2021;M;51;0;2;2565;330810;16376
Sjælland;17-8-2021;M;38;0;2;2565;330848;16378
Syddanmark;17-8-2021;M;108;0;0;2565;330956;16378
Hovedstaden;18-8-2021;F;235;0;11;2565;331191;16389
Midtjylland;18-8-2021;F;104;0;1;2565;331295;16390
Nordjylland;18-8-2021;F;38;0;1;2565;331333;16391
Sjælland;18-8-2021;F;42;0;1;2565;331375;16392
Syddanmark;18-8-2021;F;97;0;4;2565;331472;16396
Hovedstaden;18-8-2021;M;182;0;6;2565;331654;16402
Midtjylland;18-8-2021;M;104;0;1;2565;331758;16403
Nordjylland;18-8-2021;M;46;0;3;2565;331804;16406
Sjælland;18-8-2021;M;46;0;1;2565;331850;16407
Syddanmark;18-8-2021;M;73;0;1;2565;331923;16408
Hovedstaden;19-8-2021;F;230;1;10;2566;332153;16418
Midtjylland;19-8-2021;F;115;0;6;2566;332268;16424
Nordjylland;19-8-2021;F;50;0;3;2566;332318;16427
Sjælland;19-8-2021;F;51;0;3;2566;332369;16430
Syddanmark;19-8-2021;F;85;0;0;2566;332454;16430
Hovedstaden;19-8-2021;M;196;0;4;2566;332650;16434
Midtjylland;19-8-2021;M;105;0;1;2566;332755;16435
Nordjylland;19-8-2021;M;45;0;1;2566;332800;16436
Sjælland;19-8-2021;M;40;0;2;2566;332840;16438
Syddanmark;19-8-2021;M;94;0;3;2566;332934;16441
Hovedstaden;20-8-2021;F;265;0;9;2566;333199;16450
Midtjylland;20-8-2021;F;94;1;4;2567;333293;16454
Nordjylland;20-8-2021;F;40;0;1;2567;333333;16455
Sjælland;20-8-2021;F;44;0;3;2567;333377;16458
Syddanmark;20-8-2021;F;80;0;1;2567;333457;16459
Hovedstaden;20-8-2021;M;202;0;5;2567;333659;16464
Midtjylland;20-8-2021;M;100;0;2;2567;333759;16466
Nordjylland;20-8-2021;M;42;0;0;2567;333801;16466
Sjælland;20-8-2021;M;56;0;1;2567;333857;16467
Syddanmark;20-8-2021;M;57;1;3;2568;333914;16470
Hovedstaden;21-8-2021;F;232;1;14;2569;334146;16484
Midtjylland;21-8-2021;F;62;0;0;2569;334208;16484
Nordjylland;21-8-2021;F;23;0;1;2569;334231;16485
Sjælland;21-8-2021;F;30;0;0;2569;334261;16485
Syddanmark;21-8-2021;F;54;1;0;2570;334315;16485
Hovedstaden;21-8-2021;M;202;0;7;2570;334517;16492
Midtjylland;21-8-2021;M;50;0;2;2570;334567;16494
Nordjylland;21-8-2021;M;32;0;0;2570;334599;16494
Sjælland;21-8-2021;M;29;1;2;2571;334628;16496
Syddanmark;21-8-2021;M;44;1;2;2572;334672;16498
Hovedstaden;22-8-2021;F;290;0;6;2572;334962;16504
Midtjylland;22-8-2021;F;92;0;4;2572;335054;16508
Nordjylland;22-8-2021;F;35;0;1;2572;335089;16509
Sjælland;22-8-2021;F;37;0;1;2572;335126;16510
Syddanmark;22-8-2021;F;80;0;1;2572;335206;16511
Hovedstaden;22-8-2021;M;237;0;13;2572;335443;16524
Midtjylland;22-8-2021;M;77;0;2;2572;335520;16526
Nordjylland;22-8-2021;M;26;0;0;2572;335546;16526
Sjælland;22-8-2021;M;35;0;2;2572;335581;16528
Syddanmark;22-8-2021;M;65;0;4;2572;335646;16532
Hovedstaden;23-8-2021;F;247;2;10;2574;335893;16542
Midtjylland;23-8-2021;F;102;0;1;2574;335995;16543
Nordjylland;23-8-2021;F;26;0;0;2574;336021;16543
Sjælland;23-8-2021;F;53;0;4;2574;336074;16547
Syddanmark;23-8-2021;F;88;1;3;2575;336162;16550
Hovedstaden;23-8-2021;M;251;1;5;2576;336413;16555
Midtjylland;23-8-2021;M;101;1;5;2577;336514;16560
Nordjylland;23-8-2021;M;43;0;1;2577;336557;16561
Sjælland;23-8-2021;M;43;0;2;2577;336600;16563
Syddanmark;23-8-2021;M;81;1;2;2578;336681;16565
Hovedstaden;24-8-2021;F;314;0;14;2578;336995;16579
Midtjylland;24-8-2021;F;74;0;3;2578;337069;16582
Nordjylland;24-8-2021;F;34;0;3;2578;337103;16585
Sjælland;24-8-2021;F;43;0;1;2578;337146;16586
Syddanmark;24-8-2021;F;79;0;3;2578;337225;16589
Hovedstaden;24-8-2021;M;239;0;5;2578;337464;16594
Midtjylland;24-8-2021;M;78;0;4;2578;337542;16598
Nordjylland;24-8-2021;M;28;0;1;2578;337570;16599
Sjælland;24-8-2021;M;37;0;3;2578;337607;16602
Syddanmark;24-8-2021;M;83;0;3;2578;337690;16605
Hovedstaden;25-8-2021;F;302;0;11;2578;337992;16616
Midtjylland;25-8-2021;F;74;0;0;2578;338066;16616
Nordjylland;25-8-2021;F;25;0;1;2578;338091;16617
Sjælland;25-8-2021;F;47;0;1;2578;338138;16618
Syddanmark;25-8-2021;F;79;0;2;2578;338217;16620
Hovedstaden;25-8-2021;M;198;1;10;2579;338415;16630
Midtjylland;25-8-2021;M;74;0;1;2579;338489;16631
Nordjylland;25-8-2021;M;25;0;1;2579;338514;16632
Sjælland;25-8-2021;M;51;0;4;2579;338565;16636
Syddanmark;25-8-2021;M;71;0;2;2579;338636;16638
Hovedstaden;26-8-2021;F;244;0;6;2579;338880;16644
Midtjylland;26-8-2021;F;111;0;2;2579;338991;16646
Nordjylland;26-8-2021;F;40;0;0;2579;339031;16646
Sjælland;26-8-2021;F;39;0;2;2579;339070;16648
Syddanmark;26-8-2021;F;86;1;2;2580;339156;16650
Hovedstaden;26-8-2021;M;242;1;4;2581;339398;16654
Midtjylland;26-8-2021;M;85;0;0;2581;339483;16654
Nordjylland;26-8-2021;M;35;0;0;2581;339518;16654
Sjælland;26-8-2021;M;41;0;2;2581;339559;16656
Syddanmark;26-8-2021;M;89;0;0;2581;339648;16656
Hovedstaden;27-8-2021;F;197;0;9;2581;339845;16665
Midtjylland;27-8-2021;F;77;2;3;2583;339922;16668
Nordjylland;27-8-2021;F;14;1;1;2584;339936;16669
Sjælland;27-8-2021;F;36;0;0;2584;339972;16669
Syddanmark;27-8-2021;F;66;1;3;2585;340038;16672
Hovedstaden;27-8-2021;M;157;2;6;2587;340195;16678
Midtjylland;27-8-2021;M;66;1;4;2588;340261;16682
Nordjylland;27-8-2021;M;28;1;1;2589;340289;16683
Sjælland;27-8-2021;M;39;1;2;2590;340328;16685
Syddanmark;27-8-2021;M;54;0;3;2590;340382;16688
Hovedstaden;28-8-2021;F;197;2;3;2592;340579;16691
Midtjylland;28-8-2021;F;58;0;1;2592;340637;16692
Nordjylland;28-8-2021;F;13;0;1;2592;340650;16693
Sjælland;28-8-2021;F;38;0;2;2592;340688;16695
Syddanmark;28-8-2021;F;48;0;2;2592;340736;16697
Hovedstaden;28-8-2021;M;172;1;3;2593;340908;16700
Midtjylland;28-8-2021;M;59;0;5;2593;340967;16705
Nordjylland;28-8-2021;M;18;0;0;2593;340985;16705
Sjælland;28-8-2021;M;23;0;0;2593;341008;16705
Syddanmark;28-8-2021;M;37;0;3;2593;341045;16708
Hovedstaden;29-8-2021;F;204;0;10;2593;341249;16718
Midtjylland;29-8-2021;F;59;0;4;2593;341308;16722
Nordjylland;29-8-2021;F;24;1;1;2594;341332;16723
Sjælland;29-8-2021;F;35;0;2;2594;341367;16725
Syddanmark;29-8-2021;F;57;0;1;2594;341424;16726
Hovedstaden;29-8-2021;M;221;1;8;2595;341645;16734
Midtjylland;29-8-2021;M;63;0;1;2595;341708;16735
Nordjylland;29-8-2021;M;13;0;0;2595;341721;16735
Sjælland;29-8-2021;M;38;0;1;2595;341759;16736
Syddanmark;29-8-2021;M;53;0;2;2595;341812;16738
Hovedstaden;30-8-2021;F;240;0;9;2595;342052;16747
Midtjylland;30-8-2021;F;80;0;4;2595;342132;16751
Nordjylland;30-8-2021;F;30;1;1;2596;342162;16752
Sjælland;30-8-2021;F;45;0;1;2596;342207;16753
Syddanmark;30-8-2021;F;90;1;2;2597;342297;16755
Hovedstaden;30-8-2021;M;199;2;11;2599;342496;16766
Midtjylland;30-8-2021;M;66;0;2;2599;342562;16768
Nordjylland;30-8-2021;M;31;0;2;2599;342593;16770
Sjælland;30-8-2021;M;51;0;1;2599;342644;16771
Syddanmark;30-8-2021;M;66;0;1;2599;342710;16772
Hovedstaden;31-8-2021;F;217;1;4;2600;342927;16776
Midtjylland;31-8-2021;F;77;0;2;2600;343004;16778
Nordjylland;31-8-2021;F;32;0;1;2600;343036;16779
Sjælland;31-8-2021;F;35;1;1;2601;343071;16780
Syddanmark;31-8-2021;F;66;0;1;2601;343137;16781
Hovedstaden;31-8-2021;M;188;0;5;2601;343325;16786
Midtjylland;31-8-2021;M;71;0;0;2601;343396;16786
Nordjylland;31-8-2021;M;20;0;0;2601;343416;16786
Sjælland;31-8-2021;M;34;0;1;2601;343450;16787
Syddanmark;31-8-2021;M;64;0;0;2601;343514;16787
Hovedstaden;1-9-2021;F;210;0;7;2601;343724;16794
Midtjylland;1-9-2021;F;65;0;0;2601;343789;16794
Nordjylland;1-9-2021;F;22;0;4;2601;343811;16798
Sjælland;1-9-2021;F;41;0;0;2601;343852;16798
Syddanmark;1-9-2021;F;46;0;1;2601;343898;16799
Hovedstaden;1-9-2021;M;184;2;8;2603;344082;16807
Midtjylland;1-9-2021;M;49;0;1;2603;344131;16808
Nordjylland;1-9-2021;M;16;1;2;2604;344147;16810
Sjælland;1-9-2021;M;37;0;3;2604;344184;16813
Syddanmark;1-9-2021;M;41;0;1;2604;344225;16814
Hovedstaden;2-9-2021;F;156;0;7;2604;344381;16821
Midtjylland;2-9-2021;F;46;0;0;2604;344427;16821
Nordjylland;2-9-2021;F;19;0;4;2604;344446;16825
Sjælland;2-9-2021;F;39;1;1;2605;344485;16826
Syddanmark;2-9-2021;F;40;0;1;2605;344525;16827
Hovedstaden;2-9-2021;M;152;0;6;2605;344677;16833
Midtjylland;2-9-2021;M;36;0;2;2605;344713;16835
Nordjylland;2-9-2021;M;17;0;2;2605;344730;16837
Sjælland;2-9-2021;M;40;0;1;2605;344770;16838
Syddanmark;2-9-2021;M;36;0;0;2605;344806;16838
Hovedstaden;3-9-2021;F;131;0;5;2605;344937;16843
Midtjylland;3-9-2021;F;60;0;4;2605;344997;16847
Nordjylland;3-9-2021;F;13;0;1;2605;345010;16848
Sjælland;3-9-2021;F;23;0;1;2605;345033;16849
Syddanmark;3-9-2021;F;47;0;2;2605;345080;16851
Hovedstaden;3-9-2021;M;143;0;3;2605;345223;16854
Midtjylland;3-9-2021;M;45;1;2;2606;345268;16856
Nordjylland;3-9-2021;M;12;0;2;2606;345280;16858
Sjælland;3-9-2021;M;32;0;1;2606;345312;16859
Syddanmark;3-9-2021;M;25;0;0;2606;345337;16859
Hovedstaden;4-9-2021;F;121;1;3;2607;345458;16862
Midtjylland;4-9-2021;F;37;0;0;2607;345495;16862
Nordjylland;4-9-2021;F;9;0;1;2607;345504;16863
Sjælland;4-9-2021;F;15;0;1;2607;345519;16864
Syddanmark;4-9-2021;F;38;0;1;2607;345557;16865
Hovedstaden;4-9-2021;M;114;1;2;2608;345671;16867
Midtjylland;4-9-2021;M;37;3;5;2611;345708;16872
Nordjylland;4-9-2021;M;7;0;0;2611;345715;16872
Sjælland;4-9-2021;M;16;0;2;2611;345731;16874
Syddanmark;4-9-2021;M;22;1;1;2612;345753;16875
Hovedstaden;5-9-2021;F;144;1;5;2613;345897;16880
Midtjylland;5-9-2021;F;39;0;1;2613;345936;16881
Nordjylland;5-9-2021;F;11;0;2;2613;345947;16883
Sjælland;5-9-2021;F;23;0;1;2613;345970;16884
Syddanmark;5-9-2021;F;27;0;1;2613;345997;16885
Hovedstaden;5-9-2021;M;132;0;4;2613;346129;16889
Midtjylland;5-9-2021;M;30;0;3;2613;346159;16892
Nordjylland;5-9-2021;M;9;0;0;2613;346168;16892
Sjælland;5-9-2021;M;26;0;1;2613;346194;16893
Syddanmark;5-9-2021;M;26;0;0;2613;346220;16893
Hovedstaden;6-9-2021;F;162;1;8;2614;346382;16901
Midtjylland;6-9-2021;F;34;0;0;2614;346416;16901
Nordjylland;6-9-2021;F;16;0;0;2614;346432;16901
Sjælland;6-9-2021;F;58;0;1;2614;346490;16902
Syddanmark;6-9-2021;F;45;1;1;2615;346535;16903
Hovedstaden;6-9-2021;M;153;0;5;2615;346688;16908
Midtjylland;6-9-2021;M;32;0;0;2615;346720;16908
Nordjylland;6-9-2021;M;9;0;0;2615;346729;16908
Sjælland;6-9-2021;M;44;0;0;2615;346773;16908
Syddanmark;6-9-2021;M;31;0;0;2615;346804;16908
Hovedstaden;7-9-2021;F;175;2;12;2617;346979;16920
Midtjylland;7-9-2021;F;49;2;3;2619;347028;16923
Nordjylland;7-9-2021;F;11;0;1;2619;347039;16924
Sjælland;7-9-2021;F;46;0;3;2619;347085;16927
Syddanmark;7-9-2021;F;47;0;0;2619;347132;16927
Hovedstaden;7-9-2021;M;144;0;2;2619;347276;16929
Midtjylland;7-9-2021;M;50;1;2;2620;347326;16931
Nordjylland;7-9-2021;M;5;0;0;2620;347331;16931
Sjælland;7-9-2021;M;46;0;1;2620;347377;16932
Syddanmark;7-9-2021;M;35;0;1;2620;347412;16933
Hovedstaden;8-9-2021;F;133;0;3;2620;347545;16936
Midtjylland;8-9-2021;F;42;2;4;2622;347587;16940
Nordjylland;8-9-2021;F;13;0;0;2622;347600;16940
Sjælland;8-9-2021;F;32;0;0;2622;347632;16940
Syddanmark;8-9-2021;F;27;0;0;2622;347659;16940
Hovedstaden;8-9-2021;M;134;0;5;2622;347793;16945
Midtjylland;8-9-2021;M;32;0;1;2622;347825;16946
Nordjylland;8-9-2021;M;15;0;0;2622;347840;16946
Sjælland;8-9-2021;M;33;1;4;2623;347873;16950
Syddanmark;8-9-2021;M;32;0;1;2623;347905;16951
Hovedstaden;9-9-2021;F;114;0;2;2623;348019;16953
Midtjylland;9-9-2021;F;54;0;0;2623;348073;16953
Nordjylland;9-9-2021;F;17;0;0;2623;348090;16953
Sjælland;9-9-2021;F;40;0;3;2623;348130;16956
Syddanmark;9-9-2021;F;36;0;2;2623;348166;16958
Hovedstaden;9-9-2021;M;96;0;3;2623;348262;16961
Midtjylland;9-9-2021;M;37;0;2;2623;348299;16963
Nordjylland;9-9-2021;M;11;0;1;2623;348310;16964
Sjælland;9-9-2021;M;48;1;3;2624;348358;16967
Syddanmark;9-9-2021;M;33;0;0;2624;348391;16967
Hovedstaden;10-9-2021;F;84;0;1;2624;348475;16968
Midtjylland;10-9-2021;F;35;0;2;2624;348510;16970
Nordjylland;10-9-2021;F;8;0;0;2624;348518;16970
Sjælland;10-9-2021;F;33;0;2;2624;348551;16972
Syddanmark;10-9-2021;F;34;1;1;2625;348585;16973
Hovedstaden;10-9-2021;M;89;2;3;2627;348674;16976
Midtjylland;10-9-2021;M;33;0;2;2627;348707;16978
Nordjylland;10-9-2021;M;9;0;0;2627;348716;16978
Sjælland;10-9-2021;M;29;1;1;2628;348745;16979
Syddanmark;10-9-2021;M;23;0;1;2628;348768;16980
Hovedstaden;11-9-2021;F;93;1;3;2629;348861;16983
Midtjylland;11-9-2021;F;28;0;1;2629;348889;16984
Nordjylland;11-9-2021;F;7;0;0;2629;348896;16984
Sjælland;11-9-2021;F;24;0;0;2629;348920;16984
Syddanmark;11-9-2021;F;14;0;0;2629;348934;16984
Hovedstaden;11-9-2021;M;74;0;4;2629;349008;16988
Midtjylland;11-9-2021;M;26;0;2;2629;349034;16990
Nordjylland;11-9-2021;M;3;0;0;2629;349037;16990
Sjælland;11-9-2021;M;18;0;2;2629;349055;16992
Syddanmark;11-9-2021;M;18;0;0;2629;349073;16992
Hovedstaden;12-9-2021;F;89;1;2;2630;349162;16994
Midtjylland;12-9-2021;F;23;0;0;2630;349185;16994
Nordjylland;12-9-2021;F;9;0;0;2630;349194;16994
Sjælland;12-9-2021;F;21;0;0;2630;349215;16994
Syddanmark;12-9-2021;F;13;0;0;2630;349228;16994
Hovedstaden;12-9-2021;M;101;0;1;2630;349329;16995
Midtjylland;12-9-2021;M;19;1;2;2631;349348;16997
Nordjylland;12-9-2021;M;10;0;1;2631;349358;16998
Sjælland;12-9-2021;M;29;0;1;2631;349387;16999
Syddanmark;12-9-2021;M;14;0;1;2631;349401;17000
Hovedstaden;13-9-2021;F;91;0;5;2631;349492;17005
Midtjylland;13-9-2021;F;29;0;1;2631;349521;17006
Nordjylland;13-9-2021;F;17;0;1;2631;349538;17007
Sjælland;13-9-2021;F;34;0;2;2631;349572;17009
Syddanmark;13-9-2021;F;23;0;0;2631;349595;17009
Hovedstaden;13-9-2021;M;102;1;1;2632;349697;17010
Midtjylland;13-9-2021;M;33;0;1;2632;349730;17011
Nordjylland;13-9-2021;M;21;0;3;2632;349751;17014
Sjælland;13-9-2021;M;30;0;2;2632;349781;17016
Syddanmark;13-9-2021;M;25;0;0;2632;349806;17016
Hovedstaden;14-9-2021;F;82;1;0;2633;349888;17016
Midtjylland;14-9-2021;F;21;1;1;2634;349909;17017
Nordjylland;14-9-2021;F;14;0;0;2634;349923;17017
Sjælland;14-9-2021;F;28;0;2;2634;349951;17019
Syddanmark;14-9-2021;F;20;0;0;2634;349971;17019
Hovedstaden;14-9-2021;M;98;0;1;2634;350069;17020
Midtjylland;14-9-2021;M;26;0;0;2634;350095;17020
Nordjylland;14-9-2021;M;9;0;0;2634;350104;17020
Sjælland;14-9-2021;M;15;0;0;2634;350119;17020
Syddanmark;14-9-2021;M;30;0;0;2634;350149;17020
Hovedstaden;15-9-2021;F;86;0;4;2634;350235;17024
Midtjylland;15-9-2021;F;29;0;0;2634;350264;17024
Nordjylland;15-9-2021;F;17;0;1;2634;350281;17025
Sjælland;15-9-2021;F;20;0;0;2634;350301;17025
Syddanmark;15-9-2021;F;22;0;0;2634;350323;17025
Hovedstaden;15-9-2021;M;68;0;2;2634;350391;17027
Midtjylland;15-9-2021;M;25;0;0;2634;350416;17027
Nordjylland;15-9-2021;M;10;0;1;2634;350426;17028
Sjælland;15-9-2021;M;20;0;0;2634;350446;17028
Syddanmark;15-9-2021;M;18;1;3;2635;350464;17031
Hovedstaden;16-9-2021;F;71;0;3;2635;350535;17034
Midtjylland;16-9-2021;F;24;0;1;2635;350559;17035
Nordjylland;16-9-2021;F;13;0;0;2635;350572;17035
Sjælland;16-9-2021;F;18;0;1;2635;350590;17036
Syddanmark;16-9-2021;F;30;0;0;2635;350620;17036
Hovedstaden;16-9-2021;M;70;0;2;2635;350690;17038
Midtjylland;16-9-2021;M;18;0;1;2635;350708;17039
Nordjylland;16-9-2021;M;10;0;0;2635;350718;17039
Sjælland;16-9-2021;M;18;0;2;2635;350736;17041
Syddanmark;16-9-2021;M;30;0;0;2635;350766;17041
Hovedstaden;17-9-2021;F;63;0;4;2635;350829;17045
Midtjylland;17-9-2021;F;22;0;0;2635;350851;17045
Nordjylland;17-9-2021;F;6;0;1;2635;350857;17046
Sjælland;17-9-2021;F;15;0;2;2635;350872;17048
Syddanmark;17-9-2021;F;40;1;0;2636;350912;17048
Hovedstaden;17-9-2021;M;81;0;2;2636;350993;17050
Midtjylland;17-9-2021;M;24;0;0;2636;351017;17050
Nordjylland;17-9-2021;M;9;0;0;2636;351026;17050
Sjælland;17-9-2021;M;21;0;0;2636;351047;17050
Syddanmark;17-9-2021;M;27;0;1;2636;351074;17051
Hovedstaden;18-9-2021;F;49;0;1;2636;351123;17052
Midtjylland;18-9-2021;F;30;0;0;2636;351153;17052
Nordjylland;18-9-2021;F;7;0;1;2636;351160;17053
Sjælland;18-9-2021;F;17;1;2;2637;351177;17055
Syddanmark;18-9-2021;F;16;0;3;2637;351193;17058
Hovedstaden;18-9-2021;M;41;0;1;2637;351234;17059
Midtjylland;18-9-2021;M;14;0;0;2637;351248;17059
Nordjylland;18-9-2021;M;3;0;1;2637;351251;17060
Sjælland;18-9-2021;M;14;1;1;2638;351265;17061
Syddanmark;18-9-2021;M;15;0;0;2638;351280;17061
Hovedstaden;19-9-2021;F;65;0;4;2638;351345;17065
Midtjylland;19-9-2021;F;31;1;1;2639;351376;17066
Nordjylland;19-9-2021;F;8;0;0;2639;351384;17066
Sjælland;19-9-2021;F;11;0;1;2639;351395;17067
Syddanmark;19-9-2021;F;25;0;2;2639;351420;17069
Hovedstaden;19-9-2021;M;57;0;3;2639;351477;17072
Midtjylland;19-9-2021;M;22;0;0;2639;351499;17072
Nordjylland;19-9-2021;M;9;0;0;2639;351508;17072
Sjælland;19-9-2021;M;12;0;0;2639;351520;17072
Syddanmark;19-9-2021;M;29;0;1;2639;351549;17073
Hovedstaden;20-9-2021;F;67;0;1;2639;351616;17074
Midtjylland;20-9-2021;F;31;0;2;2639;351647;17076
Nordjylland;20-9-2021;F;12;0;0;2639;351659;17076
Sjælland;20-9-2021;F;40;0;1;2639;351699;17077
Syddanmark;20-9-2021;F;37;0;1;2639;351736;17078
Hovedstaden;20-9-2021;M;74;0;4;2639;351810;17082
Midtjylland;20-9-2021;M;30;0;1;2639;351840;17083
Nordjylland;20-9-2021;M;19;0;2;2639;351859;17085
Sjælland;20-9-2021;M;33;0;1;2639;351892;17086
Syddanmark;20-9-2021;M;35;1;2;2640;351927;17088
Hovedstaden;21-9-2021;F;79;1;3;2641;352006;17091
Midtjylland;21-9-2021;F;27;0;0;2641;352033;17091
Nordjylland;21-9-2021;F;13;0;0;2641;352046;17091
Sjælland;21-9-2021;F;30;0;1;2641;352076;17092
Syddanmark;21-9-2021;F;37;0;3;2641;352113;17095
Hovedstaden;21-9-2021;M;43;0;0;2641;352156;17095
Midtjylland;21-9-2021;M;34;0;2;2641;352190;17097
Nordjylland;21-9-2021;M;16;0;2;2641;352206;17099
Sjælland;21-9-2021;M;28;0;0;2641;352234;17099
Syddanmark;21-9-2021;M;31;0;1;2641;352265;17100
Hovedstaden;22-9-2021;F;77;0;2;2641;352342;17102
Midtjylland;22-9-2021;F;32;0;1;2641;352374;17103
Nordjylland;22-9-2021;F;30;0;1;2641;352404;17104
Sjælland;22-9-2021;F;27;0;1;2641;352431;17105
Syddanmark;22-9-2021;F;30;3;0;2644;352461;17105
Hovedstaden;22-9-2021;M;61;0;3;2644;352522;17108
Midtjylland;22-9-2021;M;33;0;1;2644;352555;17109
Nordjylland;22-9-2021;M;24;0;1;2644;352579;17110
Sjælland;22-9-2021;M;23;1;3;2645;352602;17113
Syddanmark;22-9-2021;M;20;0;1;2645;352622;17114
Hovedstaden;23-9-2021;F;68;0;1;2645;352690;17115
Midtjylland;23-9-2021;F;31;0;0;2645;352721;17115
Nordjylland;23-9-2021;F;28;0;0;2645;352749;17115
Sjælland;23-9-2021;F;29;0;0;2645;352778;17115
Syddanmark;23-9-2021;F;28;0;2;2645;352806;17117
Hovedstaden;23-9-2021;M;75;0;4;2645;352881;17121
Midtjylland;23-9-2021;M;27;0;0;2645;352908;17121
Nordjylland;23-9-2021;M;29;0;1;2645;352937;17122
Sjælland;23-9-2021;M;25;0;2;2645;352962;17124
Syddanmark;23-9-2021;M;27;0;2;2645;352989;17126
Hovedstaden;24-9-2021;F;80;0;3;2645;353069;17129
Midtjylland;24-9-2021;F;17;0;2;2645;353086;17131
Nordjylland;24-9-2021;F;25;0;0;2645;353111;17131
Sjælland;24-9-2021;F;33;0;3;2645;353144;17134
Syddanmark;24-9-2021;F;33;0;1;2645;353177;17135
Hovedstaden;24-9-2021;M;62;0;3;2645;353239;17138
Midtjylland;24-9-2021;M;26;1;0;2646;353265;17138
Nordjylland;24-9-2021;M;17;0;1;2646;353282;17139
Sjælland;24-9-2021;M;25;0;3;2646;353307;17142
Syddanmark;24-9-2021;M;31;0;0;2646;353338;17142
Hovedstaden;25-9-2021;F;92;0;2;2646;353430;17144
Midtjylland;25-9-2021;F;15;0;0;2646;353445;17144
Nordjylland;25-9-2021;F;16;0;0;2646;353461;17144
Sjælland;25-9-2021;F;33;0;1;2646;353494;17145
Syddanmark;25-9-2021;F;19;0;0;2646;353513;17145
Hovedstaden;25-9-2021;M;81;0;5;2646;353594;17150
Midtjylland;25-9-2021;M;14;0;0;2646;353608;17150
Nordjylland;25-9-2021;M;12;0;1;2646;353620;17151
Sjælland;25-9-2021;M;25;0;1;2646;353645;17152
Syddanmark;25-9-2021;M;26;0;2;2646;353671;17154
Hovedstaden;26-9-2021;F;80;0;1;2646;353751;17155
Midtjylland;26-9-2021;F;12;0;0;2646;353763;17155
Nordjylland;26-9-2021;F;27;0;0;2646;353790;17155
Sjælland;26-9-2021;F;27;1;2;2647;353817;17157
Syddanmark;26-9-2021;F;32;0;3;2647;353849;17160
Hovedstaden;26-9-2021;M;90;0;5;2647;353939;17165
Midtjylland;26-9-2021;M;15;0;0;2647;353954;17165
Nordjylland;26-9-2021;M;20;0;0;2647;353974;17165
Sjælland;26-9-2021;M;22;0;1;2647;353996;17166
Syddanmark;26-9-2021;M;26;0;0;2647;354022;17166
Hovedstaden;27-9-2021;F;119;0;1;2647;354141;17167
Midtjylland;27-9-2021;F;23;0;0;2647;354164;17167
Nordjylland;27-9-2021;F;24;0;1;2647;354188;17168
Sjælland;27-9-2021;F;59;0;1;2647;354247;17169
Syddanmark;27-9-2021;F;35;0;0;2647;354282;17169
Hovedstaden;27-9-2021;M;118;0;1;2647;354400;17170
Midtjylland;27-9-2021;M;24;0;1;2647;354424;17171
Nordjylland;27-9-2021;M;20;0;0;2647;354444;17171
Sjælland;27-9-2021;M;29;0;0;2647;354473;17171
Syddanmark;27-9-2021;M;31;0;1;2647;354504;17172
Hovedstaden;28-9-2021;F;151;0;1;2647;354655;17173
Midtjylland;28-9-2021;F;44;0;1;2647;354699;17174
Nordjylland;28-9-2021;F;19;0;0;2647;354718;17174
Sjælland;28-9-2021;F;37;0;3;2647;354755;17177
Syddanmark;28-9-2021;F;37;0;0;2647;354792;17177
Hovedstaden;28-9-2021;M;122;0;6;2647;354914;17183
Midtjylland;28-9-2021;M;30;0;1;2647;354944;17184
Nordjylland;28-9-2021;M;21;0;0;2647;354965;17184
Sjælland;28-9-2021;M;18;0;0;2647;354983;17184
Syddanmark;28-9-2021;M;49;1;3;2648;355032;17187
Hovedstaden;29-9-2021;F;114;0;3;2648;355146;17190
Midtjylland;29-9-2021;F;22;0;1;2648;355168;17191
Nordjylland;29-9-2021;F;16;0;0;2648;355184;17191
Sjælland;29-9-2021;F;26;0;0;2648;355210;17191
Syddanmark;29-9-2021;F;25;0;0;2648;355235;17191
Hovedstaden;29-9-2021;M;117;0;1;2648;355352;17192
Midtjylland;29-9-2021;M;28;0;1;2648;355380;17193
Nordjylland;29-9-2021;M;10;0;1;2648;355390;17194
Sjælland;29-9-2021;M;17;0;0;2648;355407;17194
Syddanmark;29-9-2021;M;32;0;0;2648;355439;17194
Hovedstaden;30-9-2021;F;113;0;0;2648;355552;17194
Midtjylland;30-9-2021;F;30;0;0;2648;355582;17194
Nordjylland;30-9-2021;F;17;0;0;2648;355599;17194
Sjælland;30-9-2021;F;32;0;1;2648;355631;17195
Syddanmark;30-9-2021;F;34;0;1;2648;355665;17196
Hovedstaden;30-9-2021;M;104;0;2;2648;355769;17198
Midtjylland;30-9-2021;M;14;0;0;2648;355783;17198
Nordjylland;30-9-2021;M;14;0;0;2648;355797;17198
Sjælland;30-9-2021;M;30;0;1;2648;355827;17199
Syddanmark;30-9-2021;M;53;0;2;2648;355880;17201
Hovedstaden;1-10-2021;F;108;0;3;2648;355988;17204
Midtjylland;1-10-2021;F;19;0;0;2648;356007;17204
Nordjylland;1-10-2021;F;8;0;0;2648;356015;17204
Sjælland;1-10-2021;F;32;0;0;2648;356047;17204
Syddanmark;1-10-2021;F;26;0;2;2648;356073;17206
Hovedstaden;1-10-2021;M;110;0;3;2648;356183;17209
Midtjylland;1-10-2021;M;17;0;1;2648;356200;17210
Nordjylland;1-10-2021;M;7;0;0;2648;356207;17210
Sjælland;1-10-2021;M;34;0;0;2648;356241;17210
Syddanmark;1-10-2021;M;32;0;0;2648;356273;17210
Hovedstaden;2-10-2021;F;88;0;1;2648;356361;17211
Midtjylland;2-10-2021;F;29;0;0;2648;356390;17211
Nordjylland;2-10-2021;F;10;0;0;2648;356400;17211
Sjælland;2-10-2021;F;32;0;0;2648;356432;17211
Syddanmark;2-10-2021;F;19;0;0;2648;356451;17211
Hovedstaden;2-10-2021;M;77;0;2;2648;356528;17213
Midtjylland;2-10-2021;M;15;0;0;2648;356543;17213
Nordjylland;2-10-2021;M;11;0;0;2648;356554;17213
Sjælland;2-10-2021;M;19;0;0;2648;356573;17213
Syddanmark;2-10-2021;M;21;0;0;2648;356594;17213
Hovedstaden;3-10-2021;F;114;0;3;2648;356708;17216
Midtjylland;3-10-2021;F;27;0;0;2648;356735;17216
Nordjylland;3-10-2021;F;10;0;0;2648;356745;17216
Sjælland;3-10-2021;F;16;0;0;2648;356761;17216
Syddanmark;3-10-2021;F;21;0;0;2648;356782;17216
Hovedstaden;3-10-2021;M;126;0;2;2648;356908;17218
Midtjylland;3-10-2021;M;32;0;1;2648;356940;17219
Nordjylland;3-10-2021;M;9;0;0;2648;356949;17219
Sjælland;3-10-2021;M;28;0;1;2648;356977;17220
Syddanmark;3-10-2021;M;21;0;0;2648;356998;17220
Hovedstaden;4-10-2021;F;94;0;2;2648;357092;17222
Midtjylland;4-10-2021;F;27;0;0;2648;357119;17222
Nordjylland;4-10-2021;F;10;0;0;2648;357129;17222
Sjælland;4-10-2021;F;29;0;1;2648;357158;17223
Syddanmark;4-10-2021;F;40;0;0;2648;357198;17223
Hovedstaden;4-10-2021;M;74;0;3;2648;357272;17226
Midtjylland;4-10-2021;M;36;0;0;2648;357308;17226
Nordjylland;4-10-2021;M;8;0;0;2648;357316;17226
Sjælland;4-10-2021;M;20;0;1;2648;357336;17227
Syddanmark;4-10-2021;M;39;0;0;2648;357375;17227
Hovedstaden;5-10-2021;M;1;0;1;2648;357376;17228
